border_size=1
usage=map

Wo          , Wo          , Wo          , Wo          , Wo          , Wo          , Wo          , Wo          , Wo          , Wo          , Wo          , Wo          , Ww          , Wo          , Wo          , Wo          , Wo          , Wo          , Wo          , Wo          , Wo          , Wo          , Wo          , Wo          , Wo          , Wo          , Wo          , Wo          , Wo          , Wo          , Wo          , Wo          
Wo          , Wo          , Wo          , Wo          , Wo          , Wo          , Wo          , Wo          , Wo          , Wo          , Ww          , Wo          , Ww          , Wo          , Ww          , Wo          , Ww          , Ww          , Ww          , Wo          , Wo          , Wo          , Wo          , Wo          , Wo          , Wo          , Wo          , Wo          , Wo          , Wo          , Wo          , Wo          
Wo          , Wo          , Wo          , Wo          , Chw         , Chw         , Chw         , Wo          , Ww          , Wo          , Ww          , Ww          , Ww          , Ww          , Ww          , Ww          , Ww          , Ww          , Ww          , Wo          , Wo          , Wo          , Wo          , Wo          , Wwr         , Ww^Vm       , Wo          , Wo          , Wo          , Wo          , Wo          , Wo          
Wo          , Wo          , Wo          , Wo          , Chw         , 2 Khw       , Chw         , Wo          , Ww          , Ww          , Wwf         , Ww          , Gs^Ft       , Ww          , Gs^Ft       , Ww          , Ww          , Ww          , Ww          , Ww          , Ww          , Ww          , Wwr         , Wwr         , Wo          , Wo          , Wo          , Wo          , Wo          , Wo          , Wo          , Wo          
Wo          , Wo          , Wo          , Wo          , Wo          , Chw         , Ww          , Wwf         , Wwf         , Wwf         , Gs^Ft       , Gs^Ft       , Gs^Ft       , Gs^Ft       , Gs^Ft       , Ds          , Ds          , Ww          , Ww          , Ww          , Ww          , Ww          , Ww          , Wwr         , Wwr         , Wo          , Wo          , Wo          , Wo          , Wo          , Wo          , Wo          
Wwr         , Wwr         , Ww          , Ww          , Ww          , Ww          , Wwf         , Wwf         , Ss          , Gg          , Gg          , Gs^Ft       , Gg          , Gs^Ft       , Gs^Ft       , Gs^Ft       , Gs^Ft       , Ds          , Ds          , Ww          , Ds          , Wwf         , Wwf         , Wwf         , Ww          , Wo          , Wo          , Ww          , Wo          , Wo          , Wo          , Wo          
Wwr         , Wwr         , Ww          , Wwf         , Wwf         , Wwf         , Ww          , Ss          , Ss          , Ss          , Gg          , Gg          , Ce          , Gg          , Gs^Ft       , Gs^Ft       , Gs^Ft       , Ds          , Ds          , Ww          , Ds          , Ds          , Wwf         , Wwf         , Ww          , Ww          , Wo          , Ww          , Ww          , Ww          , Ww          , Wo          
Ww          , Wwr         , Ww          , Ww          , Ww          , Ss          , Ss          , Ss          , Ss          , Ss          , Ss          , Gg          , Gg          , Gg          , Gg          , Gg          , Gg          , Gs^Ft       , Ss          , Ww          , Ww          , Ds          , Ds          , Wwf         , Wwf         , Ww          , Ww          , Ww          , Ww          , Ww^Vm       , Ww          , Wo          
Ww          , Ww          , Ww          , Ss          , Ss          , Ss          , Ss^Vhs      , Ss          , Ss          , Ss          , Ss          , Gg          , Gs^Ft       , Gg          , Gg          , Gg^Vc       , Gg          , Ss          , Ww          , Ww          , Ds          , Ds          , Ds          , Ds          , Wwf         , Ww          , Ww          , Ww          , Ww          , Ww          , Ww          , Wo          
Ww          , Ww          , Ww          , Ss          , Ss          , Ss          , Ss          , Ss          , Ss          , Ss          , Gg          , Gg          , Gs^Ft       , Gs^Ft       , Gs^Ft       , Gg          , Gg          , Gs^Fds      , Gs^Fds      , Ss          , Gs          , Gs^Ft       , Ds          , Ds          , Ds          , Ds          , Ds          , Ww          , Ds          , Ww          , Ww          , Ww          
Ss          , Ss          , Ss          , Ww          , Ww          , Ww          , Ww          , Ss          , Ss          , Ss          , Ss          , Gg          , Gg          , Gs^Ft       , Gs^Ft       , Gg          , Gg          , Gs^Fds      , Gg          , Gg          , Gs^Ft       , Gs^Ft       , Gs^Ft       , Ce          , Ds          , Ds          , Ds          , Ds          , Ds          , Ww          , Ww          , Ww          
Ss          , Ss          , Ss          , Ss          , Ss          , Ss          , Ss          , Ww          , Ww          , Ss          , Ss^Vhs      , Gs          , Gg          , Gs^Ft       , Gg          , Gg          , Gg          , Gg          , Gg          , Gs^Ft       , Gg          , Gg          , Gg          , Gs^Ft       , Gs^Ft       , Gs^Ft       , Ds          , Ds          , Ds          , Ds          , Ds          , Ww          
Ss          , Ss          , Ss^Vm       , Ss          , Gs          , Ss          , Gs          , Ss          , Ww          , Ss          , Ss          , Gs          , Gs          , Gg          , Gs^Fmw      , Gg          , Gs^Fmf      , Gg          , Gs^Fmw      , Gg          , Gg          , Gg^Vc       , Gg          , Gs^Ft       , Hh^Fmf      , Gs^Ft       , Gs^Ft       , Ce          , Ds          , Gs^Ft       , Gs^Ft       , Ww          
Ss          , Ss          , Ss          , Ss          , Gs          , Gs          , Gg          , Ss          , Gg          , Ww          , Ww          , Gs          , Gs^Fmf      , Gs^Fmf      , Gs^Fmf      , Gs^Fmw      , Gs^Fmf      , Gg          , Gs^Fmw      , Gg          , Gg          , Gg          , Gg          , Gs^Ft       , Hh^Fmf      , Gs^Fmf      , Gs^Fp       , Gs^Ft       , Gs^Ft       , Gs^Ft       , Ww          , Ww          
Gg          , Ss          , Ss          , Gs          , Gg          , Gg          , Gs^Fmw      , Gg          , Gs^Fmw      , Gg          , Ww          , Gs          , Gs^Fmw      , Gs^Fmw      , Gs^Fmf      , Hh^Vo       , Hh^Fmf      , Gs^Fmf      , Gs^Fmf      , Gs^Fmf      , Gs^Fmf      , Gs^Ft       , Gs^Ft       , Gs^Fp       , Hh^Fmf      , Hh^Fp       , Hh^Fp       , Gs^Fp       , Gs^Fmf      , Gs^Ft       , Ww          , Ds          
Ss          , Ss          , Gs          , Gs          , Gs          , Gg          , Gg          , Gs^Ft       , Gs^Ft       , Gs^Ft       , Gs^Fmw      , Ww          , Ww          , Gs^Fmf      , Gs^Fmw      , Hh^Fmf      , Hh^Fmf      , Gs^Fmf      , Gs^Fmf      , Gs^Fmf      , Hh^Fmf      , Hh^Fmf      , Gs^Fmf      , Hh^Fmf      , Hh^Fp       , Hh^Fp       , Hh^Fp       , Hh^Fp       , Hh^Fp       , Ww          , Hh^Fp       , Gs^Ft       
Ss          , Ss          , Ss          , Gg          , Gs          , Gs          , Gg          , Gs^Fmw      , Gs^Fmw      , Gs^Ft       , Gs^Ft       , Gs^Fmw      , Gs^Fmw      , Ww          , Ww          , Gs^Fmf      , Gs^Fmf      , Gs^Fmf      , Ggf         , Gg^Fet      , Rp          , Hh^Fp       , Hh          , Hh^Fp       , Rp          , Rp          , Rp          , Mm          , Ss          , Ss          , Hh^Fp       , Hh^Fp       
Ss          , Ss          , Gg          , Gg          , Gg          , Gg          , Gg          , Gg          , Gg          , Gg          , Gs^Ft       , Gs^Ft       , Gs^Ft       , Gs^Fmw      , Ww          , Hh^Fmf      , Hh^Fmf      , Ggf         , Ggf         , Ggf         , Rp          , Hh^Fp       , Mm          , Rp          , Ch          , Ch          , Ch          , Rp          , Mm          , Mm          , Mm          , Hh^Fp       
Ss          , Gs          , Gg          , Gs^Ft       , Gg          , Gg^Vc       , Gg          , Gg          , Gg          , Gg          , Gg          , Gs^Ft       , Gs^Ft       , Gs^Ft       , Gs^Ft       , Ww          , Hh^Fp       , Ggf         , Hh^Fp       , Ggf         , Rp          , Rp          , Rp          , Rp          , Ch          , 1 Kh        , Ch          , Rp          , Mm          , Mm^Vhh      , Mm          , Hh^Fp       
Gs          , Ss          , Gg          , Gg          , Gg          , Gg          , Gg          , Gs^Fmw      , Gs^Ft       , Gs^Ft       , Hh^Fmw      , Gg          , Gs^Ft       , Gs^Ft       , Gs^Ft       , Ww          , Ww          , Hh^Fp       , Rp          , Rp          , Rp          , Rp          , Rp          , Rp          , Rp          , Ch          , Rp          , Rp          , Mm          , Mm          , Mm          , Hh^Fp       
Gg          , Gg          , Re^Gvs      , Re^Gvs      , Gg          , Gg          , Gs^Ft       , Gs^Ft       , Hh^Fmw      , Hh^Fmw      , Mm          , Hh^Fmw      , Hh^Fmw      , Gs^Ft       , Hh^Fp       , Hh^Fp       , Ww          , Hh^Fp       , Hh^Fp       , Mm          , Mm^Vhh      , Mm          , Rp          , Rp          , Rp          , Rp          , Rp          , Rp          , Mm          , Mm          , Mm          , Hh^Fp       
Gg          , Gg          , Gg          , Gg          , Gg          , Gg          , Gs^Ft       , Gs^Ft       , Hh^Fdw      , Mm          , Mm          , Mm          , Mm          , Mm          , Mm          , Hh^Fp       , Hh^Fp       , Ww          , Hh^Fp       , Mm          , Mm          , Gs^Ft       , Rp          , Rp          , Rp          , Rp          , Mm          , Mm          , Mm          , Hh^Fp       , Hh^Fp       , Hh^Fp       
Gg          , Gg          , Gs^Ft       , Gs^Ft       , Gs^Ft       , Gs^Ft       , Gs^Ft       , Gs^Ft       , Hh^Fds      , Mm          , Mm          , Mm          , Mm          , Mm          , Mm          , Mm          , Hh^Fp       , Ww          , Hh^Fp       , Mm          , Mm          , Mm          , Mm          , Rp          , Rp          , Rp          , Gg^Fet      , Mm          , Mm          , Gs^Fp       , Gs          , Gs^Fp       
