border_size=1
usage=map

Gg          , Gg          , Gg          , Gs^Ft       , Gg          , Gg          , Gg          , Gg          , Gg          , Gs^Ft       , Ds          , Ds          , Ds          , Ds          , Ds          , Ww          , Ww          , Ww^Vm       , Ww          , Ww          , Ww          , Wo          , Wo          , Wo          , Wo          , Wo          , Wo          , Wo          , Wwf         , Wo          , Ds          
Gs^Fmf      , Gg          , Gs^Fmw      , Gg          , Gg          , Gg^Vc       , Gg          , Gg          , Hh^Fmf      , Gg          , Gg          , Ce          , Ds          , Gs^Ft       , Gs^Ft       , Ww          , Ww          , Ww          , Ww          , Ww          , Ww          , Wo          , Wo          , Wwr         , Wwr         , Wo          , Wwr         , Wwf         , Wwf         , Ds          , Ds          
Gs^Fmf      , Gg          , Gs^Fmw      , Gg          , Gg          , Gg          , Gg          , Gg          , Hh^Fmf      , Gs^Fmf      , Gs^Fp       , Gg          , Gs^Ft       , Gs^Ft       , Ww          , Ww          , Gs^Ft       , Ww          , Gs^Ft       , Ww          , Ww          , Ww          , Ww          , Wwr         , Wwr         , Wwr         , Wwf         , Wwf         , Ww          , Wwf         , Ww          
Hh^Fmf      , Gs^Fmf      , Gs^Fmf      , Gs^Fmf      , Gs^Fmf      , Gg          , Gg          , Gs^Fp       , Hh^Fmf      , Hh^Fp       , Hh^Fp       , Gs^Fp       , Ss          , Ss          , Ww          , Ds          , Ss          , Ss          , Gs^Ft       , Ds          , Ds          , Wwf         , Ww          , Wwf         , Wwr         , Wwr         , Ww          , Ww          , Wo          , Ww          , Wo          
Hh^Fmf      , Gs^Fmf      , Gs^Fmf      , Gs^Fmf      , Hh^Fmf      , Hh^Fmf      , Gs^Fmf      , Hh^Fmf      , Hh^Fp       , Hh^Fp       , Hh^Fp       , Hh^Fp       , Hh^Fp       , Ww          , Hh^Fp       , Ss          , Ss          , Ss          , Ss          , Gs^Ft       , Ds          , Wwf         , Wwf         , Wwf         , Ww          , Ww          , Wo          , Wo          , Wo          , Wo          , Wo          
Gs^Fmf      , Gs^Fmf      , Ggf         , Gg^Fet      , Rp          , Hh^Fp       , Hh          , Hh^Fp       , Rp          , Rp          , Rp          , Mm          , Ss          , Ss          , Hh^Fp       , Hh^Fp       , Gs^Ft       , Ss          , Ss          , Gs^Ft       , Gs^Ft       , Ds          , Wwf         , Ww          , Ww          , Ww          , Wo          , Wo          , Wwr         , Wo          , Wo          
Hh^Fmf      , Ggf         , Ggf         , Ggf         , Rp          , Hh^Fp       , Mm          , Rp          , Ch          , Ch          , Ch          , Rp          , Mm          , Mm          , Mm          , Hh^Fp       , Gs          , Gs^Ft       , Gs^Ft       , Ss          , Gs^Ft       , Ds          , Ds          , Wwf         , Ww          , Wo          , Wo          , Wo          , Wo          , Wwr         , Wwr         
Hh^Fp       , Ggf         , Hh^Fp       , Rp          , Rp          , Rp          , Rp          , Rp          , Ch          , 1 Kh        , Ch          , Rp          , Mm          , Mm^Vhh      , Mm          , Hh^Fp       , Gs          , Gs          , Gs^Ft       , Ss          , Ss          , Ww          , Ds          , Ww          , Ww          , Ww          , Wo          , Wo          , Wwr         , Wwr         , Wo          
Ww          , Hh^Fp       , Rp          , Rp          , Rp          , Rp          , Rp          , Rp          , Rp          , Ch          , Rp          , Rp          , Mm          , Mm          , Mm          , Hh^Fp       , Gs          , Gs^Ft       , Gs^Ft       , Gs^Ft       , Gs^Ft       , Gs^Ft       , Ds          , Ds          , Ww          , Ww          , Ww          , Wwr         , Wwr         , Wo          , Wo          
Ww          , Hh^Fp       , Hh^Fp       , Mm          , Mm^Vhh      , Mm          , Rp          , Rp          , Rp          , Rp          , Rp          , Rp          , Mm          , Mm          , Mm          , Hh^Fp       , Gg          , Gs^Ft       , Gs^Ft       , Gs^Ft       , Gs^Ft       , Gs^Ft       , Ds          , Ds          , Ds          , Ww          , Wwf         , Wwf         , Wo          , Wwr         , Wwr         
Hh^Fp       , Ww          , Hh^Fp       , Mm          , Mm          , Gs^Ft       , Rp          , Rp          , Rp          , Rp          , Mm          , Mm          , Mm          , Hh^Fp       , Hh^Fp       , Hh^Fp       , Gs          , Gs^Ft       , Gg          , Gg^Ve       , Gs^Ft       , Ds          , Ds          , Ds          , Ds          , Wwf         , Wwf         , Wo          , Wo          , Wwr         , Wo          
Gg          , Ww          , Ww          , Hh^Fp       , Mm          , Mm          , Mm          , Rp          , Rp          , Rp          , Gg^Fet      , Mm          , Mm          , Hh^Fp       , Gg          , Gs          , Gs          , Gs          , Gs          , Gs^Ft       , Ds          , Gs^Ft       , Ds          , Ds^Dr       , Ds          , Wwf         , Ww          , Ww          , Wo          , Wwr         , Wo          
Gg          , Gg          , Ww          , Hh^Fp       , Hh^Fp       , Mm          , Mm          , Rp          , Rp          , Rp^Vhc      , Gs^Fp       , Mm          , Hh^Fp       , Hh^Fp       , Gg          , Gs^Ft       , Gs^Ft       , Gs          , Gs          , Ds          , Ds          , Ds          , Ds          , Ds          , Ds          , Ds          , Ds          , Ww          , Ww          , Wo          , Wo          
Hh^Fms      , Hh^Fms      , Ww          , Ww          , Hh^Fp       , Mm          , Mm          , Mm          , Mm          , Gg^Fet      , Mm          , Gs^Fp       , Gs^Fp       , Gg          , Gs^Ft       , Gs^Ft       , Gs^Ft       , Gs          , Gs^Ft       , Ds          , Ds          , Ds          , Ds          , Ds          , Dd^Vda      , Ds          , Ww          , Ww          , Ww          , Ww          , Wo          
Mm          , Hh^Fp       , Mm          , Ww          , Ww          , Hh^Fp       , Mm          , Mm          , Mm          , Mm          , Hh^Fp       , Hh^Fp       , Gg          , Gg          , Gg          , Gs^Ft       , Gs^Ft       , Gs^Ft       , Gs^Ft       , Gs^Ft       , Gs^Ft       , Gs^Ft       , Ds          , Ds          , Ds          , Ds          , Ds          , Ww          , Ww          , Wo          , Wo          
Mm          , Mm          , Hh^Fp       , Hh^Fms      , Ww          , Hh^Fp       , Hh^Fp       , Mm          , Hh^Fp       , Hh^Fp       , Gs          , Gs          , Gs^Ft       , Gg          , Gs^Ft       , Gs^Ft       , Gs^Ft       , Gs^Ft       , Gs^Ft       , Gs^Ft       , Ds          , Gs^Ft       , Ds          , Ds          , Ds          , Ds          , Ww          , Ww          , Wo          , Wo          , Wo          
Hh^Fp       , Mm          , Hh^Fp       , Gg^Vc       , Ww          , Gs          , Gs          , Hh^Fp       , Gs          , Gs          , Gs          , Gg          , Gs^Ft       , Gg^Vc       , Gs^Ft       , Gs^Ft       , Gs^Ft       , Gs^Ft       , Ds          , Gs^Ft       , Ds          , Ds          , Ds          , Ds^Dr       , Ds          , Ww          , Wo          , Wo          , Wo          , Wo          , Wwr         
Gs^Ft       , Hh^Fp       , Hh^Fp       , Ww          , Gs^Ft       , Gs          , Gs^Ft       , Gs          , Gs^Ft       , Gs^Ft       , Gs^Ft       , Gs^Ft       , Gs^Ft       , Gs^Ft       , Gs^Ft       , Gs^Ft       , Gs^Ft       , Gs^Ft       , Gs^Ft       , Ds          , Ds          , Ds          , Ds          , Ds          , Ww          , Wwf         , Wwf         , Wo          , Wwr         , Wwr         , Wwr         
Gg          , Gs^Ft       , Gs^Ft       , Ww          , Ds          , Gs^Ft       , Gs^Ft       , Gs^Ft       , Gs^Ft       , Gs^Ft       , Gs^Ft       , Gs^Ft       , Ds          , Gs^Ft       , Gs^Ft       , Gs^Ft       , Ds          , Gs^Ft       , Gs^Ft       , Ds          , Ds          , Dd^Vdt      , Ds          , Ds          , Ww          , Wwf         , Wwf         , Wo          , Wo          , Wo          , Wo          
Ww          , Ww          , Ww          , Ww          , Ww          , Wwf         , Wwf         , Ds          , Wwf         , Ds          , Ds          , Ds          , Ds          , Gs^Ft       , Ds          , Gs^Ft       , Ds          , Gs^Ft       , Gs^Ft       , Gs^Ft       , Ds          , Ds          , Ds          , Wwf         , Wwf         , Wwf         , Wo          , Wwf         , Wo          , Wo          , Wo          
Ww          , Ww          , Ww          , Ww          , Ww          , Ww          , Ww          , Wwf         , Wwf         , Wwf         , Wwf         , Wwf         , Ds          , Ds          , Ds          , Ds          , Ds          , Ds          , Ds          , Ds          , Ds          , Ds          , Wwf         , Ww          , Wwf         , Wo          , 2 Khw       , Wo          , Wo          , Wo          , Wo          
Ww          , Ww          , Ww          , Ww          , Ww          , Ww          , Ww          , Ww          , Ww          , Ww          , Ww          , Ww          , Ww          , Wwf         , Wwf         , Wwf         , Wwf         , Wwf         , Wwf         , Wwf         , Ww          , Wwf         , Ww          , Wwf         , Wwf         , Wo          , Wo          , Wo          , Wo          , Wwr         , Wwr         
Wo          , Wo          , Wo          , Ww          , Wo          , Ww          , Ww          , Ww          , Ww          , Ww          , Wo          , Ww          , Ww          , Ww          , Ww          , Ww          , Ww          , Ww          , Ww          , Ww          , Ww          , Ww          , Wo          , Wo          , Wo          , Wo          , Wo          , Wo          , Wo          , Wwr         , Wo          
Wo          , Wo          , Wo          , Wo          , Wo          , Wo          , Wo          , Ww          , Wo          , Wo          , Wo          , Wo          , Wo          , Ww          , Wo          , Ww          , Wo          , Ww          , Wo          , Ww          , Wo          , Wo          , Wo          , Wo          , Wo          , Wo          , Wo          , Wo          , Wo          , Wo          , Wo          
Wo          , Wo          , Wo          , Wo          , Wo          , Wo          , Wo          , Wo          , Wo          , Wo          , Wo          , Wo          , Wo          , Wo          , Wo          , Wo          , Wo          , Wo          , Wo          , Wo          , Wo          , Wo          , Wo          , Wo          , Wo          , Wo          , Wo          , Wo          , Wo          , Wo          , Wo          
