border_size=1
usage=map

Wo          , Wo          , Wo          , Wo          , Wo          , Wo          , Wo          , Wo          , Wo          , Wo          , Wo          , Wo          , Wo          , Wo          , Wo          , Wo          , Wo          , Wo          , Wo          , Wo          , Wo          , Wo          , Wo          , Wo          , Wo          , Wo          , Wo          , Wo          
Wo          , Wo          , Wo          , Wo          , Ds          , Wo          , Ds          , Wo          , Wo          , Wo          , Wo          , Wo          , Wo          , Wo          , Wo          , Wo          , Wo          , Wo          , Ds          , Wo          , Ds          , Wo          , Wo          , Wo          , Wo          , Wo          , Wo          , Wo          
Wo          , Wo          , Ds          , Dd          , Md          , Ds          , Ds          , Wo          , Wo          , Wo          , Wo          , Chw         , Wo          , Wo          , Wo          , Wo          , Ds          , Ds          , Dd^Vdt      , Ds          , Md          , Ds          , Chw         , Wo          , Wo          , Wo          , Wo          , Wo          
Wo          , Wo          , Ds          , Md          , Dd^Vdt      , Wwf         , Wwf         , Wo          , Wo          , Wo          , Wo          , Wo          , Wo          , Wo          , Wo          , Wo          , Md          , Ds          , Ds          , Ds          , Ww          , Chw         , 2 Khw       , Chw         , Wo          , Wo          , Wo          , Wo          
Wo          , Wo          , Wo          , Md          , Ds          , Ds          , Wwf         , Wwf         , Ds          , Wo          , Wo          , Wo          , Wo          , Wo          , Wo          , Ds          , Ds          , Ds          , Wo          , Wo          , Wo          , Chw         , Chw         , Chw         , Ds          , Wo          , Wo          , Wo          
Wo          , Wo          , Wo          , Wo          , Wwf         , Wo          , Wo          , Ds          , Md          , Ds          , Ds          , Wwf         , Wwf         , Wwf         , Chw         , Wwf         , Dd^Vdt      , Ds          , Wo          , Wo          , Wo          , Ww          , Ds          , Ds          , Ds          , Wo          , Wo          , Wo          
Wo          , Wo          , Wo          , Wwf         , Wwf         , Wo          , Ds          , Ds          , Ds          , Ds          , Ds          , Wwf         , Wwf         , Wwf         , Wwf         , Wwf         , Wwf         , Ds          , Ds          , Wwf         , Ds          , Ds          , Dd^Vdt      , Ds          , Wo          , Wo          , Wo          , Wo          
Wo          , Wo          , Ds          , Wwf         , Wwf         , Wo          , Wwf         , Chw         , Ds          , Dd^Vda      , Ds          , Ds          , Ww          , Wwf         , Ds          , Wwf         , Ww          , Ww          , Ww          , Ww          , Ww          , Wwf         , Wwf         , Wwf         , Wo          , Wo          , Wo          , Wo          
Wo          , Ds          , Dd^Vdt      , Ds          , Wwf         , Wwf         , Wwf         , Ds          , Ds          , Ds          , Wo          , Wo          , Chw         , Ww          , Ww          , Ww          , Chw         , Ww          , Wo          , Chw         , Wo          , Wo          , Wwf         , Wo          , Wo          , Wo          , Wo          , Wo          
Wo          , Ds          , Ds          , Ds          , Ds          , Wwf         , Wwf         , Wwf         , Wo          , Wo          , Wo          , Wo          , Wo          , Ww          , Chw         , Ww          , Wo          , Wo          , Wo          , Wo          , Wo          , Wo          , Wwf         , Wo          , Wo          , Wo          , Wo          , Wo          
Wo          , Wo          , Ds          , Ds          , Wo          , Wo          , Wo          , Wwf         , Wwf         , Wo          , Wo          , Wo          , Wo          , Wwf         , Wo          , Wo          , Wo          , Wo          , Wo          , Wo          , Wwf         , Wwf         , Wwf         , Wo          , Wo          , Wo          , Wo          , Wo          
Wo          , Wo          , Wo          , Wo          , Wo          , Wo          , Wo          , Wwf         , Ds          , Ds          , Ds          , Wwf         , Wwf         , Wwf         , Wo          , Wo          , Wo          , Wo          , Wo          , Wwf         , Ds          , Wwf         , Ds          , Wwf         , Wo          , Wo          , Wo          , Wo          
Wo          , Wo          , Wo          , Wo          , Wo          , Wo          , Wo          , Ds          , Dd^Vda      , Ds          , Md          , Ds          , Wwf         , Wwf         , Wwf         , Wo          , Wo          , Wo          , Ds          , Ds          , Md          , Md          , Ds          , Ds          , Wo          , Wo          , Wo          , Wo          
Wo          , Wo          , Wo          , Wo          , Wo          , Wo          , Wo          , Ds          , Ds          , Ds          , Md          , Ds          , Ds          , Ds          , Ds          , Wwf         , Wwf         , Wwf         , Ds          , Ds          , Dd          , Md          , Ds          , Ds          , Ds          , Wo          , Wo          , Wo          
Wo          , Wo          , Wo          , Chw         , Wo          , Wo          , Wo          , Wwf         , Wwf         , Ds          , Md          , Md          , Ds          , Dd^Vdt      , Ds          , Wwf         , Wwf         , Wwf         , Wwf         , Ds          , Ds          , Ds          , Ds          , Dd^Vdt      , Ds          , Wo          , Wo          , Wo          
Wo          , Wo          , Wo          , Wo          , Wo          , Wo          , Ww          , Ww          , Wwf         , Ds          , Ds          , Md          , Ds          , Ds          , Wo          , Wwf         , Wo          , Wwf         , Wo          , Ds          , Dd^Vda      , Dd          , Ds          , Ds          , Wo          , Wo          , Wo          , Wo          
Wo          , Wo          , Wo          , Wo          , Wo          , Wo          , Ww^Vm       , Ww          , Wo          , Ds          , Wwf         , Ds          , Wwf         , Wo          , Wo          , Wo          , Wo          , Wo          , Wo          , Wo          , Ds          , Ds          , Ds          , Wo          , Wo          , Wo          , Wo          , Wo          
Wo          , Wo          , Wo          , Wo          , Wo          , Ww          , Ww          , Ww          , Wo          , Wo          , Wo          , Wwf         , Wwf         , Wwf         , Wo          , Wo          , Wo          , Wo          , Wwr         , Wo          , Wo          , Wo          , Wo          , Wo          , Wwr         , Wo          , Wo          , Wo          
Wo          , Wo          , Wo          , Wo          , Wo          , Wo          , Wo          , Wo          , Wo          , Wo          , Wwf         , Wwf         , Wwf         , Wo          , Wwr         , Wo          , Wo          , Wwr         , Wwr         , Wo          , Wo          , Wo          , Wo          , Wo          , Wwr         , Wo          , Wo          , Wo          
Wo          , Wo          , Wo          , Wo          , Wo          , Wo          , Wo          , Wo          , Wo          , Wo          , Wo          , Wwf         , Chw         , Ds          , Dd^Vdt      , Ds          , Wo          , Wo          , Wo          , Wo          , Wo          , Wo          , Wo          , Wwr         , Wo          , Wo          , Wo          , Wo          
Wo          , Wo          , Wo          , Wo          , Wwr         , Wo          , Wo          , Wo          , Wo          , Wo          , Ds          , Chw         , Ke          , Ds          , Ds          , Ds          , Wo          , Wo          , Wo          , Wo          , Wo          , Wo          , Wo          , Wo          , Ww^Vm       , Wo          , Wo          , Wo          
Wo          , Wo          , Wwr         , Wwr         , Wwr         , Wwr         , Wo          , Wo          , Wo          , Wo          , Ds          , Chw         , Chw         , Chw         , Ds          , Ds          , Wo          , Wo          , Wo          , Ds          , Ds          , Wo          , Wo          , Wo          , Wo          , Wo          , Wo          , Wo          
Wo          , Wo          , Wo          , Wo          , Wo          , Wo          , Wo          , Wo          , Wo          , Wo          , Wo          , Ds          , Ds          , Ds          , Wo          , Wo          , Wo          , Wo          , Ds          , Ds          , Ds          , Wo          , Wo          , Wo          , Wo          , Wo          , Wo          , Wo          
Wo          , Wo          , Wo          , Wo          , Wo          , Wo          , Wo          , Wo          , Wwr         , Wo          , Wo          , Wo          , Wo          , Wo          , Wo          , Wo          , Wo          , Wo          , Ds          , Dd^Vda      , Wo          , Wo          , Wo          , Wo          , Wo          , Wo          , Wo          , Wo          
Wo          , Wo          , Wo          , Wo          , Wo          , Wo          , Wo          , Wo          , Wwr         , Wwr         , Wo          , Wo          , Wo          , Wo          , Wo          , Wo          , Wo          , Ds          , Wo          , Ds          , Wo          , Wo          , Wwr         , Wwr         , Wwr         , Wo          , Wo          , Wo          
Wo          , Wo          , Wo          , Wo          , Wo          , Wo          , Wo          , Wwr         , Wo          , Wwr         , Wwr         , Wo          , Wo          , Wo          , Wo          , Wo          , Wo          , Wo          , Wo          , Wo          , Wo          , Wo          , Wwr         , Wwr         , Wo          , Wo          , Wo          , Wo          
Wo          , Wo          , Wo          , Wo          , 1 Wo        , Wo          , Wo          , Wo          , Wo          , Wo          , Wo          , Wo          , Wo          , Wo          , Wwr         , Wo          , Wwr         , Wo          , Wo          , Wo          , Wo          , Wo          , Ww          , Wwr         , Wwr         , Wo          , Wo          , Wo          
Wo          , Wo          , Wo          , Wo          , Wo          , Wo          , Wo          , Wo          , Wo          , Wo          , Wo          , Wo          , Wo          , Wwr         , Wwr         , Wwr         , Wo          , Wo          , Wo          , Wo          , Wo          , Ww^Vm       , Wo          , Wwr         , Wo          , Wo          , Wo          , Wo          
Wo          , Wo          , Wo          , Wo          , Wo          , Wo          , Wo          , Wo          , Wo          , Wo          , Wo          , Wo          , Wo          , Wo          , Wo          , Wo          , Wo          , Wo          , Wo          , Wo          , Wo          , Wo          , Wo          , Wo          , Wo          , Wo          , Wo          , Wo          
Wo          , Wo          , Wo          , Wo          , Wo          , Wo          , Wo          , Wo          , Wo          , Wo          , Wo          , Wo          , Wo          , Wo          , Wo          , Wo          , Wo          , Wo          , Wo          , Wo          , Wo          , Wo          , Wo          , Wo          , Wo          , Wo          , Wo          , Wo          
