border_size=1
usage=map

Ss          , Ss          , Ss          , Ss          , Ss          , Ss          , Ss          , Ss          , Ss          , Ss          , Ss          , Ss          , Ss          , Ss          , Ss          , Ss          , Ss          , Ss          , Ss          , Ss          , Ss          , Ss          , Ss          , Ss          , Ss          , Ss          , Ss          , Ss          , Ss          , Ss          , Ss          , Ss          , Ss          , Ss          
Ww          , Ss          , Ss          , Ss          , Ss          , Ss          , Ss          , Ss          , Ss          , Ss^Vm       , Ss          , Ss          , Ss          , Ss          , Ss          , Ss          , Ss          , Ss          , Ss          , Ss          , Ss          , Ss          , Ss          , Ss          , Ss          , Ss^Vm       , Ss          , Ss          , Ss          , Ss          , Ss          , Ss          , Ss          , Ss          
Ww          , Ww          , Ww          , Ww          , Ww          , Ww          , Ww          , Ww          , Ww          , Ss          , Ww          , Ww          , Ww          , Ww          , Ww          , Ww          , Ww          , Ww^Vm       , Ww          , Ss          , Ww          , Ss          , Ww          , Ss          , Ww          , Ss          , Ww          , Ss          , Ww          , Ss          , Ww          , Ss          , Ww          , Ss          
Wo          , Ww          , Wo          , Ww          , Wo          , Ww          , Ww          , Ww          , Ww          , Ww          , Ww          , Ww          , Ww          , Ww          , Ww          , Ww          , Ww          , Ww          , Ww          , Ww          , Ww          , Ww          , Ww          , Ww          , Ww          , Ww          , Ww          , Ww          , Ww          , Ww          , Ww          , Ww          , Ww          , Ww          
Wo          , Wo          , Wo          , Wo          , 1 Wo        , Wo          , Wo          , Wo          , Wo          , Wo          , Wo          , Wo          , Wo          , Wo          , Wo          , Wo          , Wo          , Wo          , Wo          , Wo          , Wo          , Ww          , Wo          , Ww          , Wo          , Ww          , Wo          , Wo          , Wo          , Ww          , Wo          , Ww          , Wo          , Ww          
Ww          , Wo          , Ww          , Wo          , Wo          , Wo          , Wo          , Wo          , Wo          , Wo          , Wo          , Wo          , Wo          , Wo          , Wo          , Wo          , Wo          , Wo          , Wo          , Wo          , Wo          , Wo          , Wo          , Wo          , Wo          , Wo          , Wo          , Wo          , Wo          , Wo          , Wo          , Wo          , Wo          , Wo          
Ww          , Ww          , Ww          , Ww          , Ww          , Ww          , Ww          , Wo          , Ww          , Wo          , Ww          , Ww          , Ww          , Ww          , Ww          , Wo          , Ww          , Wo          , Ww          , Wo          , Ww          , Wo          , Ww          , Wo          , Ww          , Wo          , Ww          , Ww          , Ww          , Wo          , Ww          , Wo          , Ww          , Wo          
Ww          , Ww          , Ww          , Ww          , Ww          , Ww          , Ww          , Ww          , Ww          , Ww          , Ww          , Ww          , Ww          , Ww          , Ww          , Ww          , Ww          , Ww          , Ww          , Ww          , Ww          , Ww          , Ww          , Ww          , Ww          , Ww          , Ww          , Ww          , Ww          , Ww          , Ww          , Ww          , Ww          , Ww          
Gg          , Gg          , Gg          , Ww          , Gg          , Ww          , Gg          , Ww          , Ww          , Ww          , Gg          , Ww          , Gg          , Ww          , Gg          , Ww          , Ww          , Ww          , Ww          , Ww          , Gs          , Ww          , Gs          , Ww          , Ww          , Ww          , Gs          , Ww          , Gs          , Ww          , Gs          , Ww          , Ww          , Ww          
Hh^Fmw      , Hh^Fmw      , Hh^Fmw      , Gg          , Gs^Fmw      , Gg          , Gg          , Gg          , Ww          , Gg          , Ke          , Gg          , Gs^Fmw      , Gg          , Gs^Fmw      , Gg          , Ww          , Gg          , Gg          , Gs          , Gs^Fmw      , Gg          , Gs^Fmw      , Gs          , Gg          , Gs          , Gs^Fdw      , Gg          , Gs^Fmw      , Gg          , Gs^Fmw      , Gs          , Gg          , Gs          
Mm          , Hh^Fmw      , Hh^Fmw      , Hh^Fmw      , Hh^Fmw      , Hh^Vhh      , Ww          , Ww          , Ss          , Hh^Fmw      , Ce          , Ce          , Hh^Fmw      , Hh^Fmw      , Hh^Fmw      , Hh^Fmw      , Ww          , Hh^Fmw      , Hh^Fmw      , Hh^Fmw      , Hh^Fmw      , Hh^Fmw      , Hh^Fmw      , Hh^Fmw      , Hh^Fmw      , Hh^Fmw      , Hh^Fmw      , Hh^Fmw      , Hh^Fmw      , Hh^Fmw      , Hh^Fmw      , Hh^Fmw      , Hh^Fmw      , Hh^Fmw      
Mm          , Mm          , Mm          , Mm          , Mm          , Hh^Fmw      , Ww          , Hh^Fmw      , Ss          , Mm          , Mm          , Hh^Fmw      , Mm          , Ss          , Mm          , Mm          , Mm          , Ww          , Ww          , Hh^Fmw      , Mm          , Hh^Fmw      , Mm          , Hh^Fmw      , Hh^Vhh      , Hh^Fmw      , Mm          , Mm          , Mm          , Mm          , Mm          , Hh^Fmw      , Mm          , Hh^Fmw      
Mm          , Mm          , Mm          , Mm          , Ss          , Ww          , Ss          , Mm          , Ss          , Hh^Fmw      , Mm          , Mm          , Mm          , Ss          , Hh^Fmw      , Hh^Fdw      , Mm          , Mm          , Ww          , Mm          , Mm          , Mm          , Mm          , Mm          , Mm          , Mm          , Mm          , Mm          , Mm          , Mm          , Mm          , Mm          , Mm          , Mm          
Mm          , Mm          , Hh^Fp       , Mm          , Mm          , Ww          , Ss          , Mm          , Ss          , Mm          , Mm          , Mm^Vhh      , Mm          , Ss          , Mm          , Mm          , Mm          , Ss          , Mm          , Ww          , Ww          , Hh^Fds      , Hh^Fds      , Mm          , Hh^Fds      , Hh^Fds      , Hh^Fds      , Mm          , Hh^Fds      , Hh^Fds      , Mm          , Mm          , Mm          , Mm          
Mm          , Hh^Fp       , Ss          , Ss          , Ww          , Ww          , Hh^Fms      , Ss          , Mm          , Mm          , Ss          , Mm          , Hh^Fms      , Ss          , Ss          , Ss          , Ss          , Ss          , Mm          , Mm          , Ww          , Mm          , Mm          , Mm          , Mm          , Mm          , Mm          , Mm          , Mm          , Mm          , Mm          , Mm          , Mm          , Mm          
Mm          , Mm          , Ss^Vhs      , Mm          , Ww          , Mm          , Mm          , Ss          , Hh^Fms      , Ss          , Mm          , Ss          , Mm          , Mm          , Hh^Fmw      , Mm          , Mm          , Mm          , Mm          , Ww          , Ss          , Ww          , Ww          , Hh^Fds      , Hh^Fds      , Hh^Fds      , Mm          , Mm          , Mm          , Mm^Vhh      , Mm          , Mm          , Mm          , Mm          
Mm          , Ss          , Ss          , Mm          , Ww          , Mm          , Hh^Fmw      , Mm          , Hh^Fmw      , Mm          , Mm          , Ss          , Ss          , Mm          , Hh^Fmw      , Mm          , Mm          , Mm          , Ww          , Ww          , Ss          , Ss          , Ww          , Mm          , Mm          , Hh^Fds      , Mm          , Mm          , Mm          , Mm          , Mm          , Mm          , Mm          , Mm          
Mm          , Mm          , Mm          , Ww          , Mm          , Ss          , Ss          , Ss          , Mm          , Mm          , Mm          , Mm          , Ss          , Mm          , Hh^Fmw      , Mm          , Mm          , Mm          , Ww          , Mm          , Mm          , Mm          , Mm          , Ww          , Ww          , Mm          , Mm          , Mm          , Ce          , Ce          , Ce          , Mm          , Mm          , Mm          
Mm          , Hh^Fms      , Mm          , Ww          , Mm          , Mm          , Hh^Fds      , Mm          , Mm          , Hh^Vhh      , Ss          , Ss          , Mm          , Hh^Fdw      , Mm          , Hh^Fmw      , Mm          , Ww          , Mm          , Hh^Fdw      , Mm          , Mm          , Mm          , Mm          , Ww          , Mm          , Mm          , Mm          , Ce          , 2 Ke        , Ce          , Mm          , Mm          , Mm          
Mm          , Hh^Fms      , Ww          , Ww          , Mm          , Mm          , Mm          , Hh^Fds      , Mm          , Mm          , Mm          , Ss          , Ss          , Mm          , Mm          , Mm          , Ww          , Ww          , Mm          , Hh^Fdw      , Mm          , Mm          , Mm          , Mm          , Mm          , Ww          , Ww          , Mm          , Mm          , Ce          , Mm          , Mm          , Mm          , Mm          
Mm          , Mm          , Ww          , Mm          , Mm          , Mm          , Mm          , Hh^Fds      , Hh^Fds      , Mm          , Mm          , Mm          , Mm          , Ss          , Mm          , Mm          , Ww          , Mm          , Mm          , Mm          , Mm          , Mm^Vhh      , Mm          , Mm          , Mm          , Mm          , Ww          , Mm          , Mm          , Mm          , Mm          , Mm          , Mm          , Mm          
Mm          , Mm          , Ww          , Mm          , Mm          , Mm          , Mm          , Mm          , Mm          , Mm          , Mm          , Mm          , Mm          , Ss          , Mm          , Ww          , Mm          , Mm          , Mm          , Mm          , Mm          , Mm          , Mm          , Mm          , Mm          , Mm          , Mm          , Ww          , Ww          , Mm          , Mm          , Mm          , Mm          , Mm          
