border_size=1
usage=map

Xu          , Xu          , Xu          , Xu          , Xu          , Xu          , Xu          , Xu          , Xu          , Xu          , Xu          , Xu          , Xu          , Xu          , Xu          , Xu          , Xu          , Xu          , Xu          , Xu          , Xu          , Wo          , Wo          , Xu          , Xu          , Xu          , Xu          , Xu          , Xu          , Xu          , Ss          , Uu          , Uu          , Uu          , Uu          , Uu          , Uu          , Xu          
Ww          , Ww          , Ww          , Ww          , Ww          , Ww          , Ww          , Wwf         , Wwf         , Wwf         , Wwf         , Wwf         , Wwf         , Wwf         , Ww          , Ww          , Ww          , Ww          , Wo          , Wo          , Wo          , Wo          , Ww          , Ww          , Xu          , Ss          , Ss          , Ss          , Uu          , Ss          , Uu          , Uu          , Rr          , Uu^Uf       , Rr          , Uu          , Uu          , Xu          
Wo          , Wo          , Wo          , Wo          , Wo          , Wo          , Wo          , Ww          , Wwf         , Wwf         , Wwf         , Wwf         , Wwf         , Ww          , Wo          , Ww^Vm       , Wo          , Wo          , Wo          , Wo          , Wo          , Wo          , Ww          , Ww          , Xu          , Ss          , Uu          , Uu          , Uu^Vu       , Uu          , Rr          , Rr          , Rr          , Rr          , Rr          , Cud         , Rr          , Xu          
Wo          , Wo          , Wo          , Wo          , Wo          , Wo          , Wo^Bw/      , Wo^Bw/      , Wo          , Ww          , Wo          , Ww          , Wo          , Wo^Bw\      , Wo^Bw\      , Wo          , Wo          , Wo          , Cud         , Wwf         , Cud         , Wwf         , Cud         , Wwf         , Wwf         , Uu          , Cud         , Uu          , Uu          , Uu          , Rr          , Rr          , Cud         , Cud         , Cud         , Rr          , Rr          , Xu          
Ww          , Ww          , Ww          , Ww          , Wwf         , Wwf         , Ww          , Wo          , Wo          , Wo          , Wo          , Wo          , Ww          , Wo          , Wwf         , Wo^Bw\      , Cud         , Cud         , Cud         , Wwf         , Ww          , Wwf         , Ww          , Wwf         , Xu          , Uu          , Ur          , Rr          , Rr          , Rr          , Rr          , Rr          , Cud         , 2 Kud       , Cud         , Rr          , Rr          , Xu          
Xu          , Uu          , Uu^Vu       , Wwf         , Ww          , Wwf         , Ww          , Ww          , Wo          , Wo          , Wo          , Wo          , Ww          , Ww          , Wwf         , Wwf         , Ww          , Ww          , Cud         , Ww          , Ww          , Ww          , Ww          , Xu          , Ss          , Ss          , Uu          , Uu          , Uu          , Rr          , Rr          , Rr          , Rr          , Cud         , Rr          , Rr          , Rr          , Xu          
Xu          , Uu          , Wwf         , Wwf         , Wwf         , Wwf         , Ww          , Ww          , Ww          , Wo          , Ww          , Ww          , Ww          , Wwf         , Xu          , Xu          , Xu          , Xu          , Xu          , Xu          , Xu          , Xu          , Xu          , Xu          , Xu          , Ss          , Uu          , Uu^Vu       , Uu          , Rr          , Rr          , Rr          , Rr          , Rr          , Rr          , Rr          , Rr          , Xu          
Xu          , Uu          , Ur          , Wwf         , Ww          , Ww          , Wwf         , Wwf         , Ww          , Ww          , Ww          , Wwf         , Xu          , Xu          , Ss          , Ss          , Ss          , Ss          , Ss          , Ss          , Ss          , Ss          , Ss          , Xu          , Uu          , Xu          , Xu          , Uu          , Rr          , Rr          , Rr          , Rr          , Uu          , Uu          , Uu          , Rr          , Rr          , Xu          
Xu          , Uu          , Uu          , Wwf         , Wwf         , Ww          , Ww          , Ww          , Wo          , Wwf         , Ww          , Ww          , Ss          , Ss          , Wwf         , Ww^Vm       , Wwf         , Wwf         , Wwf         , Wwf         , Wwf         , Wwf         , Wwf         , Wwf         , Wwf         , Xu          , Ww          , Xu          , Xu          , Rr          , Cud         , Rr          , Uu          , Uu^Vu       , Uu          , Rr          , Rr          , Xu          
Xu          , Xu          , Xu          , Ur          , Wwf         , Wwf         , Ww          , Ww^Vm       , Wo          , Wo          , Ww          , Ss          , Ss          , Wwf         , Wo          , Wwf         , Wo          , Wo          , Wo          , Wo          , Wo          , Wo          , Wo          , Wo          , Wo          , Wwf         , Wo          , Ww          , Wwf         , Xu          , Uu          , Uu          , Uu          , Uu          , Rr          , Rr          , Xu          , Xu          
Xu          , Cud         , Cud         , Xu          , Xu          , Wwf         , Wwf         , Ww          , Wo          , Wo          , Wo          , Wwf         , Wo          , Wo          , Wo          , Wo^Bw|      , Wo          , Wo          , Wo          , Wo          , Wo          , Wo          , Wo          , Wo          , Wo          , Wo          , Wo          , Wo          , Wo          , Wwf         , Wwf         , Uu          , Uu          , Cud         , Xu          , Xu          , Ss          , Xu          
Xu          , Cud         , Cud         , Cud         , Xu          , Wwf         , Ww          , Wwf         , Wwf         , Wwf         , Wo          , Wo          , Wo          , Wo          , Wwf         , Wwf         , Ss          , Wwf         , Ss          , Wwf         , Ss          , Wwf         , Ss          , Wwf         , Ss          , Wwf         , Wwf         , Wo          , Wwf         , Wwf         , Uu          , Uu          , Uu          , Xu          , Xu          , Ss          , Uu          , Uu          
Xu          , Cud         , Cud         , Cud         , Xu          , Wwf         , Wwf         , Wwf         , Wo^Bw|      , Wo          , Wo          , Wo          , Ww          , Ww          , Wwf         , Ss          , Xu          , Ss          , Xu          , Ss          , Xu          , Ss          , Xu          , Ss          , Xu          , Xu          , Uu          , Wwf         , Xu          , Xu          , Uu          , Uu^Vu       , Uu          , Xu          , Ss          , Uu          , Wwf         , Wwf         
Xu          , Cud         , Xu          , Xu          , Wwf         , Wwf         , Wo          , Wo          , Wo^Bw|      , Wo          , Wwf         , Wwf         , Wwf         , Wwf         , Xu          , Xu          , Uh          , Xu          , Uu          , Xu          , Uu          , Xu          , Uu          , Xu          , Uh          , Xu          , Xu          , Xu          , Ss          , Xu          , Xu          , Uu          , Xu          , Xu          , Ss          , Uu          , Wwf         , Uu          
Xu          , Cud         , Xu          , Ss          , Ss          , Wwf         , Wwf         , Wwf         , Wwf         , Wwf         , Xu          , Xu          , Xu          , Xu          , Uu          , Uu          , Uu          , Uu          , Uu          , Ss          , Ss^Vhs      , Ss          , Ss          , Ur          , Ur          , Uu          , Ur          , Uu          , Ss          , Ss          , Xu          , Ww          , Xu          , Ss          , Uu^Uf       , Ss          , Wwf         , Xu          
Xu          , Xu          , Ss          , Ss          , Cud         , Uu          , Uu          , Uu          , Uu          , Wwf         , Xu          , Uu          , Xu          , Uu          , Ww          , Uu          , Wwf         , Uu^Uf       , Wwf         , Ss          , Wwf         , Ss          , Wwf         , Uu^Uf       , Ur          , Ss          , Ss          , Uu^Vu       , Wwf         , Uu          , Xu          , Cud         , Ur          , Xu          , Uu          , Ww          , Ww          , Xu          
Xu          , Ss          , Ss          , Cud         , 3 Kud       , Cud         , Uu          , Uu^Vu       , Uu          , Ss          , Uu^Uf       , Uu          , Wwf         , Wwf         , Uu^Vud      , Wwf         , Ur          , Wwf         , Uu          , Wwf         , Ur          , Wwf         , Uu          , Xu          , Uu          , Ur          , Wwf         , Wwf         , Uu          , Uu          , Uh          , Xu          , Ur          , Xu          , Uu          , Uu^Vud      , Wwf         , Xu          
Xu          , Uu          , Uu          , Cud         , Cud         , Cud         , Ss          , Uu          , Uu          , Ss          , Wwf         , Wwf         , Ur          , Uu          , Uu          , Uu          , Uu          , Xu          , Uu          , Xu          , Uu          , Uu          , Uh          , Xu          , Uh          , Ur          , Ur          , Ur          , Uu          , Uu          , Xu          , Xu          , Ur          , Xu          , Ss          , Uu          , Wwf         , Xu          
Xu          , Uu          , Uu          , Uu          , Uu          , Uu          , Ss          , Uu^Uf       , Xu          , Ss          , Xu          , Ur          , Xu          , Uh          , Xu          , Xu          , Xu          , Xu          , Xu          , Xu          , Xu          , Xu          , Xu          , Xu          , Xu          , Xu          , Xu          , Uh          , Xu          , Uu          , Xu          , Ur          , Xu          , Xu          , Ss          , Ss          , Wwf         , Xu          
Xu          , Uu          , Xu          , Uu          , Xu          , Uu          , Xu          , Xu          , Cud         , Xu          , Cud         , Xu          , Cud         , Xu          , Cud         , Cud         , Cud         , Cud         , Cud         , Cud         , Cud         , Cud         , Cud         , Cud         , Cud         , Cud         , Ur          , Ur          , Cud         , Xu          , Xu          , Xu          , Ss          , Ss          , Ss          , Wwf         , Ss          , Xu          
Cud         , Xu          , Cud         , Xu          , Cud         , Xu          , Cud         , Cud         , Rr          , Cud         , Rr          , Cud         , Cud         , Cud         , Uu^Vud      , Cud         , Cud         , Cud         , Uu^Vud      , Cud         , Cud         , Cud         , Uu^Vud      , Cud         , Cud         , Ur          , Re          , Ur          , Ur          , Cud         , Xu          , Ss          , Ww^Vm       , Ww          , Wwf         , Wwf         , Ss          , Xu          
Cud         , Cud         , Cud         , Cud         , Cud         , Cud         , Cud         , Rr          , Rr          , Rr          , Rr          , Rr          , Cud         , Cud         , Cud         , Cud         , Cud         , Cud         , Cud         , Cud         , Cud         , Cud         , Cud         , Cud         , Cud         , Ur          , Ur          , Re          , Ur          , Cud         , Xu          , Ww          , Ww          , Ss          , Ss          , Wwf         , Ss          , Xu          
Cud         , Cud         , Cud         , Uu^Vud      , Cud         , Cud         , Cud         , Cud         , Cud         , Cud         , Cud         , Cud         , Cud         , Cud         , Cud         , Cud         , Xu          , Xu          , Xu          , Xu          , Xu          , Xu          , Xu          , Cud         , Cud         , Cud         , Ur          , Re          , Kud         , Cud         , Cud         , Xu          , Xu          , Uu          , Uu          , Ur          , Uu          , Xu          
Cud         , Cud         , Cud         , Cud         , 1 Cud       , Cud         , Cud         , Cud         , Cud         , Cud         , Cud         , Cud         , Cud         , Cud         , Cud         , Xu          , Cud         , Cud         , Cud         , Cud         , Cud         , Cud         , Cud         , Xu          , Cud         , Cud         , Uu          , Re          , Re          , Ur          , Ur          , Cud         , Xu          , Uu          , Uu          , Re          , Uu          , Xu          
Cud         , Cud         , Cud         , Cud         , Cud         , Cud         , Cud         , Cud         , Rr          , Cud         , Rr          , Cud         , Rr          , Cud         , Xu          , Xu          , Cud         , Cud         , Cud         , Cud         , Cud         , Cud         , Cud         , Xu          , Xu          , Cud         , Uu          , Uu          , Uu          , Re          , Re          , Ur          , Ur          , Ur          , Re          , Re          , Uu          , Xu          
Cud         , Cud         , Cud         , Cud         , Cud         , Cud         , Cud         , Cud         , Rr          , Rr          , Rr          , Rr          , Rr          , Cud         , Xu          , Cud         , Cud         , Cud         , Cud         , Cud         , Cud         , Cud         , Cud         , Cud         , Xu          , Cud         , Uh          , Uu          , Uu^Vud      , Uu          , Ur          , Ur          , Xu          , Ur          , Uu          , Uu          , Uu          , Xu          
Cud         , Cud         , Cud         , Cud         , Cud         , Cud         , Cud         , Cud         , Rr          , Cud         , Kud         , Cud         , Rr          , Cud         , Xu          , Cud         , Cud         , Cud         , Cud         , Cud         , Cud         , Cud         , Cud         , Cud         , Xu          , Cud         , Cud         , Uu          , Uu          , Uu          , Cud         , Cud         , Xu          , Uu          , Uu          , Uu          , Uu          , Xu          
Uu          , Cud         , Cud         , Cud         , Cud         , Xu          , Xu          , Xu          , Xu          , Xu          , Xu          , Xu          , Xu          , Xu          , Xu          , Xu          , Xu          , Xu          , Xu          , Xu          , Xu          , Xu          , Xu          , Xu          , Xu          , Xu          , Xu          , Xu          , Xu          , Xu          , Xu          , Xu          , Xu          , Xu          , Xu          , Xu          , Xu          , Xu          
