border_size=1
usage=map

Rd          , Ds          , Ds          , Xu          , Xu          , Xu          , Xu          , Xu          , Xu          , Xu          , Xu          , Xu          , Xu          , Ww          , Ww          , Wo          , Wo          , Wo          , Wo          , Ww          , Ww          , Xu          , Xu          , Xu          , Xu          , Xu          , Xu          , Xu          , Xu          
Ds          , Rd          , Rd          , Ds          , Ds          , Xu          , Xu          , Xu          , Xu          , Xu          , Hd          , Xu          , Hd          , Xu          , Xu          , Ww          , Ww          , Ww          , Ww          , Wo          , Wo          , Ww          , Ww          , Xu          , Uu          , Uu          , Ur          , Xu          , Xu          
Ds          , Ds          , Ds          , Rd          , Ds          , Hd          , Xu          , Xu          , Ds          , Ds          , Ds          , Hd          , Ds          , Ds          , Ds          , Xu          , Xu          , Xu          , Xu          , Ww          , Ww          , Wo          , Wo          , Wwf         , Xu          , Xu          , Ur          , Xu          , Xu          
Ds          , Ds          , Ds          , Rd          , Rd          , Ds          , Ds          , Xu          , Ds          , Dd^Vdt      , Ds          , Ds          , Ds          , Dd^Vdt      , Ds          , Hd          , Ds          , Ds          , Ds          , Ww          , Xu          , Ww          , Wo          , Wwf         , Xu          , Xu          , Rr          , Xu          , Xu          
Ds          , Dd^Dc       , Ds          , Ds          , Ds          , Rd          , Rd          , Ds          , Rd          , Ds          , Rd          , Ds          , Rd          , Ds          , Rd          , Ds          , Ds          , Dd^Vdt      , Ds          , Ds          , Xu          , Ww          , Wo          , Wwf         , Xu          , Rr          , Rr          , Rr          , Xu          
Ds          , Ds          , Dd^Vda      , Ds          , Ds          , Ds          , Ds          , Rd          , Ds          , Rd          , Ds          , Rd          , Ds          , Rd          , Ds          , Rd          , Rd          , Ds          , Rd          , Ds          , Wwf         , Ww          , Wo          , Wwf         , Xu          , Rr          , Rr          , Rr          , Xu          
Ds          , Ds          , Ds          , Ds          , Co          , Ds          , Ds          , Ds          , Dd^Dc       , Ds^Dr       , Dd          , Ds          , Ds          , Ds          , Hd          , Ds          , Ds          , Rd          , Ds          , Rd          , Ww^Bw\      , Wo          , Wwf         , Wwf         , Xu          , Xu          , Xu          , Xu          , Xu          
Ds          , Ds          , Ds          , Co          , 3 Kud       , Co          , Ds          , Ds          , Ds          , Ds          , Hd          , Hd          , Hd          , Hd          , Xu          , Hd          , Ds          , Ds^Dr       , Ds          , Ds          , Wwf         , Wo^Bw\      , Ww^Bw\      , Ur          , Ur          , Uu          , Uu          , Xu          , Xu          
Ds          , Ds          , Ds          , Co          , Co          , Co          , Ds          , Dd^Vdt      , Ds          , Hd          , Xu          , Xu          , Xu          , Xu          , Ww          , Xu          , Wwr         , Wwr         , Xu          , Xu          , Ww          , Wo          , Wwf         , Ur          , Uh          , Ur          , Uu^Vud      , Uu          , Xu          
Ds          , Ds          , Ds          , Ds          , Ds          , Ds          , Ds          , Ds          , Xu          , Xu          , Ww          , Ww          , Ww          , Ww          , Ww          , Xu          , Xu          , Wwr         , Ww          , Ww          , Wo          , Wo          , Wwf         , Xu          , Xu          , Ur          , Ur          , Uu          , Xu          
Ds          , Ds          , Dd^Vdt      , Ds          , Ds          , Dd^Vdt      , Ds          , Hd          , Xu          , Ww          , Chw         , Chw         , Chw         , Wo          , Wo          , Ww          , Ww          , Ww          , Wo          , Wo          , Ww          , Ww          , Ww          , Wwf         , Xu          , Ur          , Ur          , Uh          , Xu          
Ds          , Ds          , Ds          , Ds          , Ds          , Ds          , Xu          , Xu          , Ww          , Ww          , Chw         , 4 Khw       , Chw         , Wo          , Ww          , Wo          , Wo          , Wo          , Ww          , Ww          , Xu          , Xu          , Ww          , Wwf         , Xu          , Ur          , Ur          , Ur          , Xu          
Xu          , Xu          , Xu          , Xu          , Xu          , Hd          , Xu          , Ww          , Ww          , Wo          , Ww          , Chw         , Ww          , Ww          , Ww          , Ww          , Ww          , Ww          , Xu          , Xu          , Wwr         , Wwr         , Ww          , Ww          , Xu          , Uh          , Ur          , Uu          , Xu          
Ds          , Ds          , Ds          , Ds          , Ww          , Xu          , Ww          , Ww          , Ww          , Wo          , Ww          , Ww          , Wwf         , Ww          , Wwf         , Ww          , Xu          , Xu          , Ds          , Xu          , Xu          , Wwr         , Ww          , Xu          , Uu^Uf       , Uu          , Ur          , Uh          , Xu          
Ww          , Ww          , Ww          , Ww          , Ww          , Ww          , Wo          , Ww          , Wo          , Wo          , Ww          , Wwf         , Ds          , Wwf         , Ds          , Xu          , Ds          , Ds          , Ds          , Dd^Vdt      , Xu          , Wwr         , Wwf         , Ds          , Ds          , Ur          , Xu          , Xu          , Xu          
Ww          , Ww^Vm       , Ww          , Ww          , Wo          , Ww          , Wo          , Wo          , Ww          , Ww          , Wwf         , Wwf         , Ds          , Ds          , Ds          , Ds          , Xu          , Xu          , Ds          , Ds          , Xu          , Wwf         , Hd          , Dd^Vdt      , Ds          , Ur          , Cud         , 2 Kud       , Xu          
Ww          , Ww          , Wo          , Wo          , Ww          , Wo          , Ww          , Ww          , Xu          , Wwf         , Ds          , Ds          , Xu          , Xu          , Xu          , Xu          , Rd          , Rd          , Ds          , Ss          , Wwf         , Xu          , Xu          , Ds          , Ds          , Ur          , Uh          , Cud         , Xu          
Wo          , Wo          , Ww          , Ww          , Ww^Vm       , Ww          , Xu          , Xu          , Ds          , Ds          , Xu          , Xu          , Rd          , Ds          , Ds          , Rd          , Wwf         , Wwf         , Ss          , Xu          , Ss          , Wwf         , Xu          , Ds          , Uu          , Ur          , Uu^Uf       , Uu^Uf       , Xu          
Ww          , Ww          , Ww          , Ww          , Ww          , Ww          , Xu          , Ds          , Ds          , Xu          , Rd          , Rd          , Uu          , Uu^Vud      , Uu          , Xu          , Xu          , Wwf         , Wwf         , Xu          , Ww^Vm       , Wwf         , Ss          , Xu          , Xu          , Ur          , Ur          , Uu          , Xu          
Ww          , Ww          , Ds          , Ds          , Xu          , Xu          , Ds          , Ds          , Ds          , Ds          , Uu          , Xu          , Xu          , Uu          , Wwf         , Ss          , Xu          , Uu^Uf       , Uu          , Xu          , Xu          , Wwf         , Wwf         , Uu          , Xu          , Uu          , Ss          , Uu          , Xu          
Ww          , Ww          , Ds          , Ds          , Xu          , Ds          , Xu          , Xu          , Ds          , Ds          , Xu          , Ur          , Uu          , Xu          , Uu^Uf       , Wwf         , Xu          , Uu          , Wwf         , Uu^Vud      , Xu          , Uu^Uf       , Uu          , Uu          , Re          , Uu          , Re          , Re          , Xu          
Ww          , Ww          , Ds          , Xu          , Wwf         , Wwf         , Xu          , Ds          , Dd^Vdt      , Ds          , Xu          , Ur          , Ur          , Xu          , Uu          , Wwf         , Ss          , Wwf         , Uu          , Wwf         , Wwf         , Xu          , Xu          , Uu          , Uu^Vud      , Re          , Uu^Uf       , Re          , Xu          
Ww          , Ds          , Ds          , Xu          , Wwf         , Xu          , Wwf         , Wwf         , Ds          , Ds          , Xu          , Uu          , Ur          , Xu          , Xu          , Uu          , Uu          , Uu          , Xu          , Uu          , Re          , Uu          , Uu          , Xu          , Xu          , Uu          , Xu          , Uh          , Xu          
Ww          , Ds          , Xu          , Xu          , Wwf         , Wwf         , Xu          , Wwf         , Wwf         , Xu          , Ss          , Ur          , Ur          , Uu^Vu       , Xu          , Wwf         , Wwf         , Uu^Vud      , Uu          , Xu          , Xu          , Re          , Wwf         , Uu          , Uu          , Xu          , Xu          , Xu          , Xu          
Ww          , Ww          , Xu          , Wwf         , Wwf         , Xu          , Wwf         , Wwf         , Ds          , Ds          , Ur          , Ur          , Xu          , Xu          , Xu          , Xu          , Xu          , Wwf         , Wwf         , Wwf         , Xu          , Wwf         , Xu          , Wwf         , Wwf         , Ss          , Xu          , Uu          , Xu          
Ww          , Ww          , Wwf         , Wwf         , Xu          , Xu          , Wwf         , Wwf         , Xu          , Uu          , Ur          , Ss          , Xu          , Cud         , Uh          , Uu^Uf       , Uu          , Xu          , Uu          , Uu          , Re          , Xu          , Re          , Re          , Uu^Uf       , Ss          , Xu          , Cud         , Xu          
Ww          , Ww          , Wwf         , Xu          , Ss          , Wwf         , Wwf         , Wwf         , Xu          , Uu          , Ur          , Ss          , Xu          , Uu          , Ss          , Uu          , Uu^Vud      , Xu          , Xu          , Re          , Xu          , Re          , Wwf         , Wwf         , Wwf         , Ss          , Ss          , Xu          , Xu          
Wo          , Ww^Vm       , Ww          , Xu          , Ss          , Wwf         , Xu          , Xu          , Uu          , Ur          , Uu^Vu       , Uu          , Xu          , Ss          , Ss          , Uu          , Ur          , Uu          , Uu^Vud      , Xu          , Re          , Re          , Xu          , Xu          , Wwf         , Uu          , Uu^Vud      , Uu          , Xu          
Wo          , Ww          , Xu          , Xu          , Wwf         , Wwf         , Xu          , Uu          , Ur          , Ur          , Xu          , Xu          , Ww          , Xu          , Xu          , Ss          , Ss          , Ur          , Uu          , Ur          , Xu          , Xu          , Wwf         , Wwf         , Uu          , Ss          , Xu          , Uh          , Xu          
Ww          , Ww          , Xu          , Wwf         , Wwf         , Wwf         , Xu          , Uu^Uf       , Ur          , Uu          , Xu          , Wwf         , Xu          , Wwf         , Cud         , Xu          , Xu          , Xu          , Xu          , Uu          , Xu          , Re          , Ss          , Ss          , Uu          , Xu          , Uu          , Xu          , Xu          
Xu          , Xu          , Ss          , Wwf         , Ss          , Xu          , Uh          , Uu          , Ur          , Uu          , Xu          , Ss          , Wwf         , Xu          , Uu          , Uu          , Uu          , Uu          , Uu          , Xu          , Xu          , Re          , Re          , Re          , Re          , Uu^Uf       , Uu          , Uh          , Xu          
Xu          , Ss          , Ss^Vm       , Wwf         , Xu          , Xu          , Uu^Vu       , Ur          , Uu^Vu       , Uu          , Cud         , Xu          , Wwf         , Xu          , Xu          , Uu          , Rr          , Rr          , Rr          , Uu          , Uu          , Xu          , Xu          , Xu          , Re          , Re          , Uu          , Uh          , Xu          
Xu          , Ss          , Wwf         , Wwf         , Xu          , Cud         , Cud         , Cud         , Cud         , Cud         , Xu          , Xu          , Wwf         , Wwf         , Xu          , Ss          , Rr          , Rr          , Rr^Vd       , Rr          , Rr          , Uu          , Xu          , Ss          , Re          , Re          , Cud         , Xu          , Xu          
Xu          , Ss          , Wwf         , Xu          , Uu^Uf       , Xu          , Xu          , Xu          , Xu          , 5 Kud       , Xu          , Ww^Vm       , Wwf         , Xu          , Ss          , Ss          , Rr          , Rr          , Rr          , Rr          , Rr          , Uu          , Xu          , Ss          , Wwf         , Re          , Cud         , Cud         , Xu          
Xu          , Ss          , Wwf         , Xu          , Ss          , Uu          , Uu          , Ql          , Uu          , Xu          , Wwf         , Wwf         , Xu          , Xu          , Ss          , Uu          , Re          , Rr          , Re          , Rr          , Uu          , Uu          , Xu          , Ss          , Wwf         , Wwf         , Cud         , Kud         , Xu          
Xu          , Ww          , Wwf         , Xu          , Uu          , Cud         , Uu          , Ql          , Uu          , Xu          , Wwf         , Wwf         , Xu          , Ss          , Ss          , Re          , 1 Ur        , Re          , Uu          , Re          , Re          , Xu          , Xu          , Ss          , Re          , Xu          , Xu          , Xu          , Xu          
Xu          , Ww^Vm       , Wwf         , Xu          , Xu          , Uu          , Xu          , Ql          , Xu          , Cud         , Xu          , Wwf         , Wwf         , Xu          , Ss          , Re          , Re          , Uu          , Ss          , Ss          , Ss          , Re          , Re          , Ss          , Re          , Re          , Ss          , Xu          , Xu          
Xu          , Ww          , Ss          , Wwf         , Wwf         , Xu          , Ww          , Xu          , Ww          , Xu          , Wwf         , Wwf         , Ww          , Xu          , Xu          , Uu          , Re          , Uu          , Uu          , Xu          , Xu          , Ss          , Ss          , Re          , Uu          , Uu          , Uu^Vud      , Xu          , Xu          
Xu          , Ss          , Ss          , Ww          , Ww          , Wwf         , Wwf         , Wwf         , Wwf         , Wwf         , Ww          , Ww          , Ww^Vm       , Xu          , Xu          , Uu          , Uu          , Re          , Uu          , Ss          , Xu          , Xu          , Xu          , Uu          , Xu          , Xu          , Xu          , Xu          , Xu          
Xu          , Xu          , Xu          , Xu          , Xu          , Xu          , Xu          , Xu          , Xu          , Xu          , Xu          , Xu          , Xu          , Xu          , Xu          , Xu          , Uu          , Re          , Re          , Uu          , Ss          , Xu          , Xu          , Xu          , Xu          , Xu          , Xu          , Xu          , Xu          
