border_size=1
usage=map

Rd          , Ds          , Ds          , Xu          , Xu          , Xu          , Xu          , Xu          , Xu          , Xu          , Xu          , Xu          , Xu          , Ww          , Ww          , Wo          , Wo          , Wo          , Wo          , Ww          , Ww          , Xu          , Xu          , Xu          , Xu          , Xu          , Xu          , Xu          
Ds          , Rd          , Rd          , Ds          , Ds          , Xu          , Xu          , Xu          , Xu          , Xu          , Hd          , Xu          , Hd          , Xu          , Xu          , Ww          , Ww          , Ww          , Ww          , Wo          , Wo          , Ww          , Xu          , Xu          , Uu          , Xu          , Xu          , Xu          
Ds          , Ds          , Ds          , Rd          , Ds          , Hd          , Xu          , Xu          , Ds          , Ds          , Ds          , Hd          , Ds          , Ds          , Ds          , Xu          , Xu          , Xu          , Xu          , Ww          , Wo          , Wwf         , Wwf         , Uu          , Xu          , Uu          , Xu          , Xu          
Ds          , Ds          , Ds          , Rd          , Rd          , Ds          , Ds          , Xu          , Ds          , Dd^Vdt      , Ds          , Ds          , Ds          , Dd^Vdt      , Ds          , Hd          , Ds          , Ds          , Ds          , Ww          , Ww          , Wo          , Wwf         , Xu          , Rr          , Rr          , Rr          , Xu          
Ds          , Dd^Dc       , Ds          , Ds          , Ds          , Rd          , Rd          , Ds          , Rd          , Ds          , Rd          , Ds          , Rd          , Ds          , Rd          , Ds          , Ds          , Dd^Vdt      , Ds          , Xu          , Ww          , Wo          , Wwf         , Xu          , Rr          , Rr          , Rr          , Xu          
Ds          , Ds          , Dd^Vda      , Ds          , Ds          , Ds          , Ds          , Rd          , Ds          , Rd          , Ds          , Rd          , Ds          , Rd          , Ds          , Rd          , Rd          , Ds          , Ds          , Xu          , Ww          , Wo          , Wwf         , Xu          , Xu          , Rr          , Xu          , Xu          
Ds          , Ds          , Ds          , Ds          , Co          , Ds          , Ds          , Ds          , Dd^Dc       , Ds^Dr       , Dd          , Ds          , Ds          , Ds          , Hd          , Ds          , Ds          , Rd          , Rd          , Ds          , Wwf         , Wo          , Wwf         , Xu          , Xu          , Xu          , Xu          , Xu          
Ds          , Ds          , Ds          , Co          , 3 Kud       , Co          , Ds          , Ds          , Ds          , Ds          , Hd          , Hd          , Hd          , Hd          , Xu          , Hd          , Ds          , Ds^Dr       , Ds          , Rd          , Ww^Bw\      , Wo          , Wwf         , Xu          , Uu          , Uu          , Uu          , Xu          
Ds          , Ds          , Ds          , Co          , Co          , Co          , Ds          , Dd^Vdt      , Ds          , Hd          , Xu          , Xu          , Xu          , Xu          , Ww          , Xu          , Wwr         , Wwr         , Xu          , Xu          , Ww          , Wo^Bw\      , Ww^Bw\      , Ur          , Uu          , Uu^Vud      , Uu          , Xu          
Ds          , Ds          , Ds          , Ds          , Ds          , Ds          , Ds          , Ds          , Xu          , Xu          , Ww          , Ww          , Ww          , Ww          , Ww          , Xu          , Xu          , Wwr         , Ww          , Ww          , Wo          , Wo          , Wwf         , Ur          , Ur          , Uu          , Uh          , Xu          
Ds          , Ds          , Dd^Vdt      , Ds          , Ds          , Dd^Vdt      , Ds          , Hd          , Xu          , Ww          , Chw         , Chw         , Chw         , Wo          , Wo          , Ww          , Ww          , Ww          , Wo          , Wo          , Ww          , Ww          , Wwf         , Xu          , Ur          , Uu          , Xu          , Xu          
Ds          , Ds          , Ds          , Ds          , Ds          , Ds          , Xu          , Xu          , Ww          , Ww          , Chw         , 4 Khw       , Chw         , Wo          , Ww          , Wo          , Wo          , Wo          , Ww          , Ww          , Xu          , Ww          , Xu          , Xu          , Ur          , Uu          , Xu          , Xu          
Xu          , Xu          , Xu          , Xu          , Xu          , Hd          , Xu          , Ww          , Ww          , Wo          , Ww          , Chw         , Ww          , Ww          , Ww          , Ww          , Ww          , Ww          , Xu          , Xu          , Wwr         , Wwr         , Xu          , Ur          , Uu^Vud      , Uu          , Xu          , Xu          
Ds          , Ds          , Ds          , Ds          , Ww          , Xu          , Ww          , Ww          , Ww          , Wo          , Ww          , Ww          , Wwf         , Ww          , Wwf         , Ww          , Xu          , Xu          , Dd^Vdt      , Xu          , Ww          , Wwr         , Xu          , Ur          , Uu          , Uu          , Xu          , Xu          
Ww          , Ww          , Ww          , Ww          , Ww          , Ww          , Wo          , Ww          , Wo          , Wo          , Ww          , Wwf         , Ds          , Wwf         , Ds          , Xu          , Ds          , Ds          , Ds          , Xu          , Ss          , Ww          , Wwf         , Ur          , Uu^Uf       , Uu          , Xu          , Xu          
Ww          , Ww^Vm       , Ww          , Ww          , Wo          , Ww          , Wo          , Wo          , Ww          , Ww          , Wwf         , Wwf         , Ds          , Ds          , Ds          , Ds          , Xu          , Xu          , Ds          , Xu          , Ss          , Wwf         , Hd          , Xu          , Xu          , Wwf         , Xu          , Xu          
Ww          , Ww          , Wo          , Wo          , Ww          , Wo          , Ww          , Ww          , Xu          , Wwf         , Ds          , Ds          , Xu          , Xu          , Xu          , Xu          , Rd          , Rd          , Ss          , Xu          , Xu          , Hd          , Ds          , Dd^Vdt      , Xu          , Wwf         , Xu          , Xu          
Wo          , Wo          , Ww          , Ww          , Ww^Vm       , Ww          , Xu          , Xu          , Ds          , Ds          , Xu          , Xu          , Rd          , Ds          , Ds          , Rd          , Wwf         , Re          , Xu          , Wwf         , Ss          , Xu          , Uu          , Uu          , Xu          , Uu          , Xu          , Xu          
Ww          , Ww          , Ww          , Ww          , Ww          , Ww          , Xu          , Ds          , Ds          , Xu          , Rd          , Rd          , Uu          , Uu^Vud      , Uu          , Xu          , Wwf         , Re          , Xu          , Wwf         , Ww^Vm       , Xu          , Uu^Uf       , Re          , Xu          , Uu          , Uu          , Xu          
Ww          , Ww          , Ds          , Ds          , Xu          , Xu          , Ds          , Ds          , Ds          , Ds          , Uu          , Xu          , Xu          , Uu          , Xu          , Xu          , Uu          , Xu          , Wwf         , Wwf         , Xu          , Xu          , Re          , Re          , Ss          , Ur          , Ss          , Xu          
Ww          , Ww          , Ds          , Ds          , Xu          , Ds          , Xu          , Xu          , Ds          , Ds          , Xu          , Uu          , Xu          , Wwf         , Xu          , Ss          , Re          , Xu          , Xu          , Wwf         , Xu          , Uu^Vud      , Xu          , Re          , Re          , Ur          , Uu          , Xu          
Ww          , Ww          , Ds          , Xu          , Wwf         , Wwf         , Xu          , Ds          , Dd^Vdt      , Ds          , Xu          , Uu          , Xu          , Wwf         , Wwf         , Xu          , Ss          , Re          , Xu          , Wwf         , Uu          , Xu          , Re          , Xu          , Xu          , Re          , Uu^Vud      , Xu          
Ww          , Ds          , Ds          , Xu          , Wwf         , Xu          , Wwf         , Wwf         , Wwf         , Ds          , Xu          , Uu          , Uu          , Xu          , Re          , Xu          , Xu          , Wwf         , Xu          , Uu^Vud      , Xu          , Re          , Xu          , Wwf         , Uu          , Re          , Uu^Uf       , Xu          
Ww          , Ds          , Ds          , Xu          , Wwf         , Wwf         , Xu          , Xu          , Wwf         , Xu          , Ss          , Xu          , Uu          , Xu          , Uu^Vud      , Wwf         , Xu          , Wwf         , Uu          , Xu          , Wwf         , Xu          , Wwf         , Xu          , Xu          , Uh          , Cud         , Xu          
Ww          , Ww          , Ww          , Xu          , Wwf         , Ss          , Xu          , Wwf         , Ds          , Xu          , Ur          , Uu          , Xu          , Xu          , Xu          , Wwf         , Wwf         , Xu          , Xu          , Wwf         , Xu          , Uu          , Xu          , Wwf         , Xu          , Cud         , 2 Kud       , Xu          
Ww          , Ww^Vm       , Ww          , Xu          , Wwf         , Xu          , Wwf         , Wwf         , Xu          , Uu          , Ur          , Ss          , Xu          , Cud         , Uh          , Xu          , Xu          , Wwf         , Uu          , Xu          , Re          , Xu          , Re          , Re          , Uu          , Xu          , Xu          , Xu          
Ww          , Ww          , Xu          , Xu          , Wwf         , Xu          , Wwf         , Xu          , Uu          , Uu          , Uu          , Xu          , Ss          , Uu          , Uu^Uf       , Uu          , Uu^Vud      , Xu          , Xu          , Re          , Xu          , Re          , Wwf         , Uu          , Uu^Vud      , Uu          , Xu          , Xu          
Wo          , Ww          , Ww          , Wwf         , Xu          , Xu          , Wwf         , Xu          , Uu          , Uu^Vu       , Xu          , Xu          , Xu          , Ss          , Ss          , Uu          , Uu          , Uu          , Uu^Vud      , Xu          , Re          , Re          , Xu          , Uu          , Uu          , Uu          , Xu          , Xu          
Wo          , Wo          , Ww          , Ww          , Xu          , Wwf         , Xu          , Xu          , Ur          , Uu          , Xu          , Ss          , Ww          , Xu          , Xu          , Ss          , Ss          , Ur          , Uu          , Ur          , Xu          , Xu          , Wwf         , Wwf         , Xu          , Ss          , Xu          , Xu          
Ww          , Ww          , Xu          , Xu          , Wwf         , Wwf         , Xu          , Uu^Uf       , Ur          , Xu          , Ss          , Wwf         , Xu          , Wwf         , Cud         , Xu          , Xu          , Xu          , Xu          , Uu          , Xu          , Re          , Ss          , Xu          , Uu          , Xu          , Xu          , Xu          
Xu          , Xu          , Ss          , Wwf         , Ss          , Xu          , Uu          , Uu          , Uu          , Xu          , Wwf         , Xu          , Ss          , Xu          , Uu          , Uu          , Uu          , Uu          , Uu          , Xu          , Xu          , Re          , Re          , Re          , Re          , Uu^Uf       , Xu          , Xu          
Xu          , Ss          , Ss^Vm       , Wwf         , Xu          , Xu          , Uu          , Uu^Vu       , Uu          , Xu          , Wwf         , Xu          , Xu          , Ss          , Uu          , Rr          , Rr          , Rr          , Rr          , Uu          , Xu          , Uu          , Xu          , Xu          , Re          , Ss          , Xu          , Xu          
Xu          , Ss          , Wwf         , Wwf         , Xu          , Uu          , Ur          , Uu          , Uu          , Xu          , Xu          , Wwf         , Xu          , Ss          , Ss          , Rr          , Rr          , Rr^Vd       , Rr          , Uu          , Xu          , Uu^Vud      , Xu          , Cud         , Re          , Ss          , Ss          , Xu          
Xu          , Ss          , Wwf         , Xu          , Uu^Uf       , Uu          , Ur          , Uu          , Uu^Vu       , Uu          , Xu          , Ww          , Ss^Vm       , Xu          , Ss          , Uu          , Rr          , Rr          , Rr          , Uu          , Uu^Uf       , Xu          , Cud         , Cud         , Re          , Ss          , Xu          , Xu          
Xu          , Ss          , Wwf         , Xu          , Ss          , Uu          , Cud         , Uu          , Uu          , Uu          , Xu          , Wwf         , Xu          , Xu          , Uu          , Uu          , Re          , Rr          , Re          , Uu          , Uu          , Xu          , Kud         , Cud         , Re          , Ss          , Xu          , Xu          
Xu          , Ww          , Wwf         , Xu          , Cud         , Cud         , 5 Kud       , Cud         , Cud         , Uu          , Xu          , Wwf         , Xu          , Ss          , Uu          , 1 Re        , Uu          , Re          , Uu          , Re          , Re          , Xu          , Xu          , Xu          , Re          , Ss          , Xu          , Xu          
Xu          , Ww^Vm       , Wwf         , Xu          , Xu          , Xu          , Xu          , Xu          , Xu          , Uh          , Xu          , Wwf         , Wwf         , Xu          , Uu          , Re          , Re          , Uu          , Xu          , Ss          , Ss          , Re          , Re          , Ss          , Re          , Uu          , Xu          , Xu          
Xu          , Ww          , Ss          , Wwf         , Wwf         , Xu          , Xu          , Xu          , Xu          , Xu          , Wwf         , Wwf         , Ww          , Xu          , Xu          , Uu          , Re          , Uu          , Uu          , Xu          , Xu          , Ss          , Ss          , Re          , Uu          , Uu          , Xu          , Xu          
Xu          , Ss          , Ss          , Ww          , Ww          , Wwf         , Wwf         , Wwf         , Wwf         , Wwf         , Ww          , Ww          , Ww^Vm       , Xu          , Xu          , Uu          , Uu          , Re          , Re          , Uu          , Ss          , Xu          , Xu          , Uu          , Xu          , Uu^Vud      , Xu          , Xu          
Xu          , Xu          , Xu          , Xu          , Xu          , Xu          , Xu          , Xu          , Xu          , Xu          , Xu          , Xu          , Xu          , Xu          , Xu          , Xu          , Xu          , Uu          , Re          , Uu          , Ss          , Xu          , Xu          , Xu          , Xu          , Xu          , Xu          , Xu          
