border_size=1
usage=map

Rp          , Rp          , Rp          , Rp          , Rp          , Rp          , Rp          , Rp          , Rp          , Rp          , Rp          , Rp          , Rp          , Rp          , Rp          , Rp          , Rp          , Rp          , Rp          , Rp          , Rp          , Rp          , Rp          , Rp          , Rp          , Rp          , Rp          , Rp          , Rp          , Aa^Fda      , Ms          , Ms          , Ha^Fpa      , Ha^Fpa      
Rp          , Rp          , Rp          , Rp          , Rp          , Rp          , Aa          , Rp          , Rp          , Rp          , Rp          , Aa          , Aa          , Rp          , Rp          , Rp          , Rp          , Rp          , Rp          , Rp          , Rp          , Rp          , Rp          , Rp          , Rp          , Rp          , Rp          , Rp          , Aa          , Aa^Fda      , Ms          , Ha^Fpa      , Ww          , Ww          
Rp          , Rp          , Rp          , Rp          , Ch          , Rp          , Aa          , Rp          , Ch          , Ch          , Ch          , Rp          , Rp          , Rp          , Ch          , Rp          , Rp          , Rp          , Rp          , Rp          , Chw         , Rp          , Rp          , Rp          , Rp          , Rp          , Ch          , Rp          , Aa          , Aa^Fda      , Ha^Fpa      , Ha^Fpa      , Ww          , Ha^Fpa      
Aa          , Rp          , Rp          , Rp          , Rp          , Rp          , Rp          , Rp          , Ch          , 3 Kh        , Ch          , Rp          , Rp          , Rp          , Rp          , Rp          , Aa          , Rp          , Ai          , Ai          , Ds          , Ww          , Ww          , Rp          , Gs^Fms      , Rp          , Aa          , Aa          , Aa          , Ha^Fpa      , Ww          , Ww          , Ha^Fpa      , Ha^Fpa      
Aa          , Ch          , Aa          , Aa          , Rp          , Rp          , Rp          , Rp          , Rp          , Ch          , Rp          , Rp          , Rp          , Aa          , Aa          , Aa          , Aa^Voa      , Aa          , Wwf         , Ds          , Ds          , Ds          , Wwf         , Gs^Fms      , Ce          , Ce          , Ce          , Rd          , Rd          , Ha^Fpa      , Ww          , Ha^Fpa      , Ha^Vhha     , Ms          
Gg          , Aa          , Gg          , Aa          , Ch          , Rp          , Rp          , Rp          , Rp          , Rp          , Rp          , Rp          , Rp          , Rp          , Ch          , Gs          , Gs          , Gs          , Ww          , Ds          , Ds          , Ds          , Ww          , Gs^Fms      , Ce          , 4 Ke        , Ce          , Ha^Fda      , Ai          , Ww^Bw\      , Ss^Bw\      , Ha^Fpa      , Ha^Fma      , Ms          
Gs          , Gg          , Gg^Vo       , Gg          , Gs          , Aa          , Aa          , Rp          , Aa          , Rp          , Rp          , Rp          , Aa          , Aa          , Gs          , Gs          , Ww          , Ww          , Aa          , Ww          , Ww          , Ww          , Ai          , Gs^Fms      , Ss          , Ce          , Aa^Fma      , Ha^Fpa      , Ww          , Ww          , Ss          , Rd          , Rd          , Ha^Fma      
Gs          , Gg          , Gg          , Gg          , Aa^Fpa      , Aa          , Gs          , Ch          , Aa          , Aa          , Aa          , Ch          , Gs          , Aa          , Aa          , Ww          , Aa          , Aa          , Ss          , Ss          , Ww          , Ai          , Ww          , Ss          , Ww          , Ss          , Ss          , Ww          , Ss          , Ss          , Ss          , Ss          , Rd          , Ha^Fda      
Ww          , Gs          , Gs          , Aa^Fpa      , Aa^Fpa      , Gs          , Gg          , Gg          , Gg          , Aa          , Gs          , Gs          , Ww          , Ai          , Ww          , Ww          , Ss          , Ss          , Ai          , Ai          , Ai          , Ww          , Ai          , Ww          , Ss          , Ww          , Ww          , Ww          , Ss          , Ss^Vhs      , Gs          , Aa          , Rd          , Gg          
Gg          , Ww          , Aa^Fpa      , Gs          , Aa^Fpa      , Aa^Fpa      , Gg          , Gg^Vo       , Gg          , Gs          , Ww          , Gs          , Ww^Bw\      , Gg          , Gg          , Aa          , Aa          , Ai          , Ss          , Ss          , Ss          , Ss          , Aa          , Ai          , Gs^Fms      , Gs^Fms      , Gs^Fms      , Gs^Fms      , Gg          , Gs          , Gs          , Aa          , Gg          , Rd          
Gg          , Ai          , Ai          , Aa^Fpa      , Ai          , Ai          , Aa^Fpa      , Gg          , Ww          , Ww          , Gg          , Ww          , Gg          , Rd          , Rd          , Gg          , Gg          , Ss          , Gg          , Aa          , Aa          , Aa          , Gg          , Gg          , Gg          , Gs^Fmf      , Gg          , Gs^Fmf      , Gg          , Gs          , Gs          , Gs          , Gg          , Gg          
Gg          , Aa^Fma      , Aa^Fma      , Ai          , Aa^Fma      , Ai          , Ai          , Ww          , Aa          , Aa          , Aa          , Gg          , Gs^Fms      , Gg          , Rd          , Rd          , Rd          , Gg          , Rd          , Gg          , Gg          , Gg          , Gg          , Gg^Vo       , Gg          , Gg          , Gg          , Gg          , Gs^Fms      , Gg          , Gg          , Gg          , Aa          , Aa          
Gg          , Gg          , Gg          , Gg          , Gg          , Aa^Fma      , Gg          , Gg          , Aa          , Aa          , Aa          , Gs^Fmf      , Gg          , Gg          , Rd          , Gg          , Gg          , Rd          , Gg          , Rd          , Rd          , Rd          , Rd          , Gg          , Rd          , Gg          , Gg          , Gg          , Gg          , Gg          , Gg          , Aa          , Gg          , Aa          
Gg          , Gg          , Gg          , Gg          , Gg          , Gg          , Gs^Fmf      , Gg          , Gg          , Gg          , Gg          , Gg          , Gg          , Rd          , Gg          , Gg          , Aa^Fpa      , Gg          , Aa          , Gg          , Gg          , Gg          , Gg          , Rd          , Gg          , Rd          , Rd          , Rd          , Rd          , Gg          , Rd          , Gg          , Gg          , Gg          
Aa          , Aa          , Aa          , Gg          , Gg          , Gg          , Gs^Fms      , Gs^Fms      , Gg          , Gg          , Gg^Vo       , Gg          , Rd          , Rd          , Gg          , Gg          , Gg          , Aa          , Aa          , Gg          , Gg          , Gg          , Gs^Fms      , Gg          , Gs^Fms      , Gg          , Gg          , Gg          , Gg          , Rd          , Gg          , Rd          , Rd          , Rd          
Aa          , Aa          , Gg          , Gg          , Gg^Vc       , Gg          , Gg          , Gg          , Gg          , Gg          , Gg          , Gg          , Rd          , Gg          , Gg          , Gg          , Gs^Fms      , Gg          , Gg          , Aa          , Gg          , Gg          , Aa          , Gs^Fmf      , Aa          , Gg          , Ss          , Gg          , Gg          , Gg          , Gg          , Gg          , Gg          , Gg          
Gg          , Aa          , Gg          , Gg          , Gg          , Gg          , Aa          , Aa          , Aa          , Gg          , Gg          , Rd          , Gg          , Gg          , Aa          , Gg          , Gg          , Gs^Fms      , Gg          , Aa          , Gg          , Gg          , Gg          , Aa          , Aa^Voa      , Aa          , Ss          , Ss          , Gg          , Gg          , Gg          , Gg^Vh       , Gg          , Gg          
Gg          , Gg          , Gg          , Gg          , Gg          , Gg          , Aa          , Gg          , Gg          , Gg          , Rd          , Rd          , Gg          , Gg          , Aa          , Aa          , Gg          , Gg          , Gg          , Gg          , Gg          , Gg          , Gg          , Aa          , Aa          , Aa          , Gg          , Gg          , Gg          , Gg          , Gg          , Gg          , Gg          , Gg          
Aa          , Aa          , Gg          , Gg          , Gg          , Gg          , Gg          , Gg          , Gg          , Gg          , Rd          , Gg          , Gg          , Aa          , Aa          , Gg          , Gg          , Gg^Vo       , Gg          , Gg          , Gg          , Gg          , Gg          , Gg          , Gg          , Gg          , Gg          , Gg          , Ce          , Ce          , Ce          , Gg          , Gg          , Gg          
Aa          , Gg          , Aa          , Gg          , Ce          , Ce          , Ce          , Gg          , Gg          , Rd          , Gg          , Gg          , Gg          , Gg          , Gg          , Gg          , Gg          , Gg          , Aa          , Gg          , Gg          , Gs^Fms      , Gs^Fmf      , Gs^Fms      , Gg          , Gg          , Gg          , Gg          , Ce          , 1 Ke        , Ce          , Gg          , Gg          , Gg          
Gg          , Aa          , Gg          , Gg          , Ce          , 2 Ke        , Ce          , Gg          , Rd          , Rd          , Gg          , Gg          , Gg          , Gg          , Gg          , Gg          , Gg          , Gg          , Aa          , Aa          , Gg          , Gs^Fms      , Gs^Fms      , Gg          , Gg          , Gg          , Gg          , Gg          , Gg          , Ce          , Gg          , Gg          , Gg          , Gg          
Gg          , Gg          , Gs^Fms      , Gg          , Gg          , Ce          , Gg          , Gg          , Rd          , Gg          , Gg^Vo       , Gg          , Gg          , Gg          , Aa          , Gg          , Gg          , Aa          , Aa          , Aa          , Gg          , Gg          , Gg          , Gg          , Gg          , Gg          , Aa          , Gg          , Aa          , Gg          , Aa          , Aa          , Aa          , Gg          
Gg          , Gg          , Gs^Fms      , Gs^Fmf      , Gg          , Gg          , Gg          , Rd          , Gg          , Gg          , Gg          , Gg          , Aa          , Aa          , Aa          , Gg          , Gg          , Gg          , Gg          , Gg          , Gg          , Gs          , Gs          , Gs          , Gs          , Gg          , Gg          , Aa          , Aa          , Aa          , Ha^Fda      , Aa          , Aa^Fda      , Aa          
Gg          , Gs^Fp       , Gs^Fp       , Gg          , Gg          , Gg          , Rd          , Rd          , Gg          , Gg          , Gg          , Gg          , Gg          , Aa          , Gg          , Gg          , Gg          , Gg          , Gg          , Gg          , Gs          , Gs          , Gs          , Gs^Vht      , Gs          , Gg          , Aa          , Aa          , Ha^Fda      , Aa^Fda      , Ha^Fma      , Ha^Fma      , Aa^Fda      , Aa^Fda      
Gg          , Gs^Fp       , Gg          , Gg          , Gg          , Gg          , Rd          , Gg          , Gg          , Gg          , Gg          , Gg          , Gg          , Gg          , Gg          , Gg          , Gg          , Gg          , Gg          , Gg          , Gg          , Gs          , Gg          , Gs          , Gg          , Aa          , Aa          , Ha^Fpa      , Ha^Fpa      , Ha^Fpa      , Ha^Fpa      , Ha^Fpa      , Ha^Fpa      , Aa^Fda      
