border_size=1
usage=map

Gs          , Gs          , Aa          , Aa          , Ha^Fpa      , Ha          , Ha          , Ai          , Ai          , Ms          , Ai          , Ai          , Ai          , Ha^Fma      , Ha^Fpa      , Ms          , Ms          , Ms          , Ha^Fma      , Ms          , Ha^Fma      , Aa          , Ai          , Ai          , Ha^Fma      , Aa          , Aa          , Aa          , Gs          , Gs          , Gs          , Aa          , Gs          , Gs          , Gs          , Ds          , Ds          , Ww          , Ww          , Ww          , Wo          , Wo          , Ww          , Ww          , Ww          , Ds          
Gs          , Gs          , Gs          , Aa          , Aa          , Ha^Fpa      , Aa^Vha      , Ha^Fpa      , Ha^Fpa      , Ai          , Ha^Fma      , Ha^Fma      , Ai          , Aa          , Ha^Fma      , Ha^Fma      , Ha^Fpa      , Ha^Fma      , Aa          , Ha^Fma      , Aa          , Aa          , Ai          , Aa          , Aa^Fda      , Aa          , Aa^Fda      , Gs          , Gs          , Gs^Vht      , Gs          , Gs          , Ds          , Gs          , Ds          , Ds          , Ww          , Ww          , Ww          , Ww          , Wo          , Ww          , Ww          , Ww          , Ds          , Ds          
Aa          , Aa          , Gs          , Aa          , Gs          , Hh^Fdw      , Hh^Fdw      , Ha^Fpa      , Hh^Fdw      , Ha^Fma      , Aa^Fma      , Aa^Fma      , Ai          , Aa          , Aa          , Aa          , Aa          , Aa          , Aa          , Aa          , Gs          , Aa^Fda      , Ww          , Aa^Fda      , Gs          , Aa^Fda      , Gs          , Gs          , Gs          , Ds          , Ds          , Ds          , Ww          , Ds          , Ww          , Ww          , Ww          , Ww          , Wo          , Wo          , Ww          , Ww          , Ww          , Ds          , Ds          , Ds          
Gs          , Gs          , Aa^Fma      , Gs          , Gs          , Gs          , Hh^Fdw      , Hh^Fdw      , Aa          , Ha^Fpa      , Ww          , Ai          , Ai          , Aa          , Aa          , Rd          , Aa          , Aa^Voa      , Aa          , Gs          , Ss          , Gs          , Ss          , Gs          , Ss          , Gs          , Gs          , Gs          , Ds          , Ds          , Ds          , Ds          , Ww          , Ww          , Ww          , Ww          , Wo          , Wo          , Ww          , Ww          , Ww          , Ww          , Ds          , Ww          , Ss          , Ds          
Gg          , Aa^Fma      , Aa^Fma      , Aa          , Gs^Fmf      , Gs          , Gs          , Gs          , Aa          , Aa          , Ss          , Ai          , Ss          , Ai          , Rd          , Rd          , Aa          , Aa          , Gs          , Gs          , Gs          , Ss          , Ss          , Ss          , Ss^Vhs      , Ss          , Gs          , Gs          , Ds          , Ds          , Ww          , Ww          , Ww          , Ww          , Wo          , Ww^Vm       , Wo          , Wo          , Wo          , Ww          , Ww          , Ds          , Ds          , Ds          , Ss          , Ss          
Gg          , Gg          , Aa^Fma      , Gs^Fmf      , Aa^Fma      , Aa          , Aa^Fma      , Aa          , Aa^Fma      , Ss          , Ss^Vhs      , Ss          , Ss          , Ss          , Rd          , Aa          , Aa          , Aa^Fma      , Gs^Fmf      , Aa^Fma      , Aa^Fma      , Gs^Fmf      , Ss          , Ss          , Ds          , Ss          , Ds          , Ds          , Ds          , Ds          , Ww          , Ww          , Ww          , Wo          , Wo          , Wo          , Wo          , Ww          , Ww          , Ww          , Ds          , Ds          , Ww          , Ww          , Ds          , Ds          
Gg          , Gg^Vo       , Gg          , Gs^Fmf      , Aa          , Aa^Fma      , Gs^Fmf      , Aa^Fma      , Ss          , Ss          , Ss          , Aa          , Rd          , Ss^Bw/      , Ss          , Aa          , Ss          , Aa^Fma      , Gs          , Gs          , Gs          , Gs          , Ss          , Ss          , Ss          , Ds          , Ds          , Ds          , Ww          , Ww          , Ww          , Ww          , Wo          , Wo          , Wo          , Ww          , Ww          , Ww          , Ds          , Ww          , Ds          , Ds          , Ww          , Ds          , Hd          , Hd          
Aa          , Gg          , Gs          , Aa          , Aa^Fma      , Aa^Fma      , Ss          , Ss          , Aa^Fda      , Aa^Fda      , Aa          , Aa          , Aa          , Aa          , Ss          , Ss          , Ss          , Gs          , Ds          , Gs          , Ds          , Ds          , Ss          , Ss          , Ww          , Ds          , Ww          , Ww          , Ww^Vm       , Ww          , Ww          , Ww          , Wo          , Wo          , Ww          , Ww          , Ww          , Ww          , Ds          , Ds          , Ds          , Ds          , Hd          , Ww          , Hd          , Md          
Gg          , Gg          , Gs          , Gs          , Ss          , Ss          , Aa^Fda      , Ss          , Aa          , Aa          , Aa          , Rd          , Aa          , Aa          , Gs          , Ss          , Ss          , Ds          , Ds          , Ds          , Ds          , Ss          , Ww          , Ss          , Ww          , Ww          , Ww          , Ww          , Ww          , Ww          , Wo          , Wo          , Wo          , Wo          , Ww          , Ww          , Ss          , Ds          , Ds          , Ds          , Hd          , Hd          , Md          , Hd          , Md          , Md          
Rd          , Gg          , Aa          , Ai          , Aa          , Aa          , Aa          , Aa^Fda      , Aa          , Aa          , Aa          , Rd          , Gs          , Aa          , Aa^Vca      , Gs          , Ds          , Ss          , Ww          , Ww          , Wwf         , Ww          , Ww          , Ww          , Ww          , Wo          , Wo          , Wo          , Wo          , Wo          , Wo          , 1 Wo        , Wo          , Wo          , Ww          , Ww          , Ss          , Ds          , Ds          , Hd          , Md          , Md          , Hd          , Hd          , Hd          , Hd          
Gs          , Rd          , Rd          , Aa          , Rd          , Aa          , Rd          , Aa          , Rd          , Rd          , Gs          , Gs          , Ds          , Gs          , Gs          , Gs          , Ds          , Ds          , Ww          , Ww          , Wwf         , Ww          , Wo          , Wo          , Wo          , Wo          , Wo          , Wo          , Wo          , Wo          , Ww          , Wo          , Ww          , Ww          , Ww          , Ss          , Ss^Vhs      , Ds          , Ds          , Hd          , Md          , Hd          , Ds          , Ds          , Ds          , Ds          
Gs          , Gs          , Gs          , Aa          , Aa          , Rd          , Aa          , Aa          , Aa          , Gs          , Ss          , Ds          , Ds          , Ds          , Ds          , Ds          , Wwf         , Ww          , Wwf         , Wwf         , Ww          , Ww          , Wo          , Wo          , Wo          , Wo          , Wo          , Wo          , Wo          , Wo          , Ww          , Ww          , Ww          , Ww          , Ds          , Ds          , Ss          , Ss          , Ds          , Hd          , Md          , Hd          , Ds          , Dd^Vdt      , Ds          , Ds          
Gs          , Ss          , Gs          , Gs          , Co          , Co          , Co          , Aa          , Gg          , Gg          , Gg          , Ss          , Ss          , Wwf         , Wwf         , Ds          , Wwf         , Ww          , Wwf         , Ww^Vm       , Ww          , Ww          , Ww          , Ww          , Wo          , Wo          , Wo          , Ww          , Wwf         , Ww          , Wwf         , Wwf         , Wwf         , Ds          , Dd^Dc       , Ds          , Ss          , Ds          , Hd          , Hd          , Md          , Hd          , Ds          , Ds          , Ds          , Ss          
Gs          , Gs          , Ss          , Gs          , Chr         , 3 Ko        , Co          , Gs          , Gs          , Gg^Vo       , Gg          , Ss          , Ww          , Ww          , Wwf         , Wwf         , Wwf         , Wwf         , Ww          , Wwf         , Ww          , Ww          , Wo          , Wo          , Wo          , Wo          , Ww          , Ww          , Wwf         , Wwf         , Ww          , Wwf         , Ds          , Ds          , Ds          , Ds          , Ds          , Ds          , Hd          , Md          , Md          , Hd          , Hd          , Ds          , Ds          , Ss          
Ss          , Ss          , Rp          , Rp          , Rp          , Chr         , Rp          , Gs          , Ss          , Gg          , Ss          , Ss          , Ww          , Wwf         , Ww          , Wwf         , Wwf         , Ww          , Wwf         , Wwf         , Ww          , Wo          , Wo          , Wo          , Wo          , Wo          , Wwf         , Wwf         , Ww          , Ww          , Ss          , Ds          , Ds          , Dd^Vda      , Ds          , Ds          , Ds          , Hd          , Md          , Md          , Md          , Md          , Hd          , Ds          , Ss          , Ss          
Ss          , Ss          , Ww          , Rp          , Rp          , Rp          , Rp          , Ss          , Ss          , Ss          , Ww          , Ww          , Wwr         , Wwr         , Wo          , Ww          , Ww          , Wwf         , Wwr         , Wwr         , Wo          , Wo          , Khw         , Chw         , Ww          , Ww^Vm       , Wwf         , Ww          , Wwf         , Wwf         , Ss          , Ss          , Ss          , Ds          , Ss          , Ds          , Ds          , Hd          , Hd          , Md          , Md          , Md          , Hd          , Ds          , Ds          , Ss          
Ww          , Ww          , Ww          , Ww^Bw/      , Ww^Bw/      , Rp          , Ds          , Gs          , Ss          , Ss          , Ww          , Wwr         , Wwr         , Wo          , Wo          , Wo          , Ww          , Wwr         , Wwr         , Wwr         , Chw         , Chw         , Wo          , Wwr         , Wwf         , Ww          , Wwf         , Ds          , Ds          , Ds          , Ds          , Ds          , Ds          , Ss          , Ds          , Ds          , Hd          , Hd          , Md          , Md          , Hd          , Hd          , Ds          , Ds          , Ww          , Ss          
Ww          , Ww          , Ww          , Ww          , Ww          , Ds          , Dd^Vda      , Ds          , Ww          , Ww          , Ww          , Ww          , Wwr         , Wwr         , Wo          , Wo          , Wo          , Wo          , Ww          , Chw         , Wo          , Wo          , Ww          , Wwr         , Ww          , Wwf         , Ww          , Wwf         , Wwf         , Ds          , Ds          , Ds^Dr       , Ds          , Ds          , Hd          , Ds          , Hd          , Hd          , Md          , Hd          , Hd          , Ds          , Ss          , Ss^Vm       , Ww          , Ds          
Wo          , Wo          , Wo          , Ww          , Wwf         , Ds          , Ds          , Ds          , Ww          , Ww          , Ww          , Wo          , Wo          , Wwr         , Wwr         , Wo          , Wo          , Wo          , Wo          , Wo          , Wo          , Wo          , Wo          , Ww          , Wwf         , Wwf         , Wwf         , Wwf         , Ds          , Ds          , Ds          , Ds          , Ce          , Ce          , Ce          , Hd          , Hd          , Md          , Hd          , Md          , Hd          , Ds          , Ds          , Ss          , Ds          , Ds          
Wo          , Wo          , Wo          , Ww          , Ww          , Ds          , Ds          , Ww          , Wwr         , Ww          , Wo          , Wo          , Ww^Vm       , Wwr         , Chw         , Chw         , Wo          , Wo          , Wo          , Wo          , Wo          , Wo          , Ww          , Ww          , Wwf         , Ww          , Wwf         , Wwf         , Ds          , Ds          , Ds          , Ds          , Ce          , 4 Ke        , Ce          , Hd          , Ds          , Hd          , Hd          , Md          , Md          , Hd          , Ds          , Ss          , Ss          , Ds          
Wo          , Wo          , Wo          , Wo          , Ww          , Ww          , Ww          , Ww          , Wwr         , Wwr         , Wo          , Wo          , Wo          , Wo          , Chw         , 2 Khw       , Chw         , Chw         , Wo          , Wo          , Wo          , Ww          , Wo          , Ww          , Ww          , Ww          , Ww          , Wwf         , Ww          , Ds          , Rd          , Rd          , Ds          , Ce          , Ds          , Ds          , Ds          , Ds          , Ds          , Hd          , Md          , Hd          , Ds          , Ds          , Ss          , Ds          
Wo          , Wo          , Wo          , Wo          , Wo          , Wo          , Ww          , Wwr         , Wwr         , Wo          , Wo          , Wo          , Wo          , Wo          , Wwr         , Chw         , Wo          , Wo          , Wo          , Wo          , Wo          , Wo          , Wo          , Ww          , Wo          , Ww          , Wo          , Ww          , Ww          , Ds          , Rd          , Ds          , Ds          , Ds          , Ds          , Ds          , Ds          , Ds          , Ds          , Hd          , Hd          , Hd          , Ds          , Ss          , Ds          , Ds          
Wo          , Wo          , Wo          , Ww^Vm       , Wo          , Wo          , Wo          , Wo          , Wwr         , Wwr         , Wo          , Wwr         , Wwr         , Wwr         , Wwr         , Wwr         , Ww^Vm       , Wo          , Wo          , Wwr         , Wo          , Wo          , Wo          , Wo          , Wo          , Wo          , Wo          , Ww          , Ww          , Ww^Bw/      , Rd          , Ds          , Ds^Dr       , Ds          , Ds          , Dd^Vdt      , Ds          , Ds          , Ds          , Hd          , Ds          , Ds          , Ss          , Ss          , Ds          , Ds          
Wo          , Wo          , Wo          , Wo          , Wo          , Wo          , Wo          , Wo          , Wo          , Wo          , Wo          , Wo          , Wwr         , Wo          , Wo          , Wo          , Wo          , Wo          , Wo          , Wwr         , Wwr         , Wo          , Wo          , Wo          , Ww^Vm       , Wo          , Wo          , Wo          , Ww          , Ww^Bw/      , Ds          , Ds          , Ds          , Ds          , Ds          , Ds          , Ds          , Ds          , Ds          , Ds          , Ds          , Ds          , Ss          , Ds          , Ds          , Ds          
Wo          , Wo          , Wo          , Wo          , Wwr         , Wwr         , Wo          , Wo          , Wo          , Wo          , Wo          , Wo          , Wo          , Wo          , Wo          , Wo          , Wo          , Wo          , Wo          , Wwr         , Wo          , Wo          , Wo          , Wo          , Wo          , Wo          , Wo          , Wo          , Wo          , Ww          , Ww          , Ds          , Ds          , Ds          , Ss          , Ss          , Ss          , Ss          , Ss          , Ss          , Ss          , Ss          , Ss          , Ss          , Ds          , Ds          
Wo          , Wo          , Wo          , Wo          , Wo          , Wo          , Wo          , Wo          , Wo          , Wo          , Wo          , Wo          , Wo          , Wo          , Wo          , Wo          , Wo          , Wo          , Wo          , Wo          , Wo          , Wo          , Wo          , Wo          , Wo          , Wo          , Wo          , Wo          , Wo          , Wo          , Ww          , Ww          , Ds          , Ds          , Ds          , Ds          , Ds          , Ds          , Ds          , Ss          , Ss          , Ss          , Ss          , Ss          , Ss          , Ss          
