border_size=1
usage=map

Gs          , Gs          , Aa          , Aa          , Ha^Fpa      , Ha          , Ha          , Ai          , Ai          , Ms          , Ai          , Ai          , Ai          , Ha^Fma      , Ha^Fpa      , Ms          , Ms          , Ms          , Ha^Fma      , Ms          , Ha^Fma      , Aa          , Ai          , Ai          , Ha^Fma      , Aa          , Aa          , Aa          , Gs          , Gs          , Gs          , Aa          , Aa          , Aa          , Gs          , Ds          , Ds          
Gs          , Gs          , Gs          , Aa          , Aa          , Ha^Fpa      , Aa^Vha      , Ha^Fpa      , Ha^Fpa      , Ai          , Ha^Fma      , Ha^Fma      , Ai          , Aa          , Ha^Fma      , Ha^Fma      , Ha^Fpa      , Ha^Fma      , Aa          , Ha^Fma      , Aa          , Aa          , Ai          , Aa          , Aa^Fda      , Aa          , Aa^Fda      , Gs          , Gs          , Gs^Vht      , Gs          , Gs          , Gs          , Gs          , Ds          , Ds          , Ww          
Aa          , Aa          , Gs          , Aa          , Gs          , Hh^Fdw      , Hh^Fdw      , Ha^Fpa      , Hh^Fdw      , Ha^Fma      , Aa^Fma      , Aa^Fma      , Ai          , Aa          , Aa          , Aa          , Aa          , Aa          , Aa^Voa      , Aa          , Gs          , Aa^Fda      , Ww          , Aa^Fda      , Gs          , Aa^Fda      , Gs          , Gs          , Gs          , Ds          , Ds          , Ds          , Ds          , Ds          , Ww          , Ww          , Ww          
Gs          , Gs          , Aa^Fma      , Gs          , Gs          , Gs          , Hh^Fdw      , Hh^Fdw      , Aa          , Ha^Fpa      , Ww          , Ai          , Ai          , Aa          , Aa          , Rd          , Aa          , Aa          , Aa          , Gs          , Ss          , Gs          , Ss          , Gs          , Ss          , Gs          , Gs          , Gs          , Ds          , Ds          , Ds          , Ds          , Ww          , Ww          , Ww          , Ww          , Wo          
Gg          , Aa^Fma      , Aa^Fma      , Aa          , Gs^Fmf      , Gs          , Gs          , Gs          , Aa          , Aa          , Ss          , Ai          , Ss          , Ai          , Rd          , Rd          , Aa          , Aa          , Gs          , Gs          , Gs          , Ss          , Ss          , Ss          , Ss^Vhs      , Ss          , Gs          , Gs          , Ds          , Ds          , Ww          , Ww          , Ww          , Ww          , Wo          , Ww^Vm       , Wo          
Gg          , Gg          , Aa^Fma      , Gs^Fmf      , Aa^Fma      , Aa          , Aa^Fma      , Aa          , Aa^Fma      , Ss          , Ss^Vhs      , Ss          , Ss          , Ss          , Rd          , Aa          , Aa          , Aa^Fma      , Gs^Fmf      , Aa^Fma      , Aa^Fma      , Gs^Fmf      , Ss          , Ss          , Ds          , Ss          , Ds          , Ds          , Ds          , Ds          , Ww          , Ww          , Ww          , Wo          , Wo          , Wo          , Wo          
Gg          , Gg^Vo       , Gg          , Gs^Fmf      , Aa          , Aa^Fma      , Gs^Fmf      , Aa^Fma      , Ss          , Ss          , Ss          , Aa          , Rd          , Ss^Bw/      , Ss          , Aa          , Ss          , Aa^Fma      , Gs          , Gs          , Gs          , Gs          , Ss          , Ss          , Ss          , Ds          , Ds          , Ds          , Ww          , Ww          , Ww          , Ww          , Wo          , Wo          , Wo          , Wo          , Ww          
Aa          , Gg          , Gs          , Aa          , Aa^Fma      , Aa^Fma      , Ss          , Ss          , Aa^Fda      , Aa^Fda      , Aa          , Aa          , Aa          , Aa          , Ss          , Ss          , Ss          , Gs          , Ds          , Gs          , Ds          , Ds          , Ss          , Ss          , Ww          , Ds          , Ww          , Ww          , Ww^Vm       , Ww          , Ww          , Wo          , Wo          , Wo          , Ww          , Ww          , Ww          
Gg          , Gg          , Gs          , Gs          , Ss          , Ss          , Aa^Fda      , Ss          , Aa          , Aa          , Aa          , Rd          , Aa          , Gs          , Gs          , Ss          , Ss          , Ds          , Ds          , Ds          , Ds          , Ss          , Ww          , Ww          , Ww          , Ww          , Ww          , Ww          , Ww          , Ww          , Wo          , Wo          , Wo          , Wo          , Ww          , Ww          , Ss          
Rd          , Gg          , Aa          , Ai          , Aa          , Aa          , Aa          , Aa^Fda      , Aa          , Aa          , Rd          , Rd          , Gs          , Aa          , Aa^Vca      , Gs          , Ds          , Ss          , Ww          , Ww          , Wwf         , Ww          , Ww          , Ww          , Ww          , Ww          , Ww          , Ww          , Wo          , Wo          , Wo          , 1 Wo        , Wo          , Wo          , Ww          , Ww          , Ss          
Gs          , Rd          , Rd          , Aa          , Rd          , Aa          , Rd          , Aa          , Rd          , Rd          , Gs          , Gs          , Ds          , Gs          , Gs          , Gs          , Ds          , Ds          , Ww          , Ww          , Wwf         , Ww          , Wo          , Wo          , Wo          , Ww          , Wo          , Wo          , Wo          , Wo          , Wo          , Wo          , Ww          , Ww          , Ww          , Ss          , Ss          
Gs          , Gs          , Gs          , Aa          , Aa          , Rd          , Aa          , Aa          , Aa          , Gs          , Ss          , Ds          , Ds          , Ds          , Ds          , Ds          , Wwf         , Ww          , Wwf         , Wwf         , Ww          , Ww          , Wo          , Wo          , Wo          , Wo          , Wo          , Wo          , Wo          , Wo          , Ww          , Ww          , Ww          , Ww          , Ds          , Ss          , Ds          
Gs          , Ss          , Gs          , Gs          , Co          , Co          , Co          , Aa          , Gg          , Gg          , Gg          , Ss          , Ss          , Wwf         , Wwf         , Ds          , Wwf         , Ww          , Wwf         , Ww^Vm       , Ww          , Ww          , Ww          , Wo          , Wo          , Wo          , Wo          , Wo          , Wwf         , Ww          , Wwf         , Wwf         , Wwf         , Ds          , Dd^Dc       , Ds          , Ds          
Gs          , Gs          , Ss          , Gs          , Chr         , 3 Ko        , Co          , Gs          , Gs          , Gg^Vo       , Gg          , Ss          , Ww          , Ww          , Wwf         , Wwf         , Wwf         , Wwf         , Ww          , Wwf         , Ww          , Ww          , Wo          , Wo          , Wo          , Wo          , Ww          , Ww^Vm       , Wwf         , Wwf         , Ww          , Wwf         , Ds          , Ds          , Ds          , Ds          , Rd          
Ss          , Ss          , Rp          , Rp          , Rp          , Chr         , Rp          , Gs          , Ss          , Gg          , Ss          , Ss          , Ww          , Wwf         , Ww          , Wwf         , Wwf         , Ww          , Wwf         , Wwf         , Wo          , Wo          , Wo          , Wo          , Wo          , Wo          , Wwf         , Wwf         , Ww          , Ww          , Ss          , Ds          , Ds          , Dd^Vda      , Ds          , Rd          , Ds          
Ss          , Ss          , Ww          , Rp          , Rp          , Rp          , Rp          , Ss          , Ss          , Ss          , Ww          , Ww          , Wwr         , Wwr         , Wo          , Ww          , Ww          , Wwf         , Wwr         , Wwr         , Wo          , Wo          , Khw         , Chw         , Wo          , Ww          , Wwf         , Ww          , Wwf         , Wwf         , Ss          , Ss          , Ss          , Ds          , Rd          , Rd          , Ds          
Ww          , Ww          , Ww          , Ww^Bw/      , Ww^Bw/      , Rp          , Ds          , Gs          , Ss          , Ss          , Ww          , Wwr         , Wwr         , Wo          , Wo          , Wo          , Wo          , Wo          , Wwr         , Wwr         , Chw         , Chw         , Wo          , Wwr         , Wwf         , Ww          , Wwf         , Wwf         , Ds          , Ww          , Ds          , Ds          , Ds          , Ds          , Rd          , Ds          , Ds          
Ww          , Ww          , Ww          , Ww          , Ww          , Ds          , Dd^Vda      , Ds          , Ww          , Ww          , Ww          , Ww          , Wwr         , Wwr         , Wo          , Wo          , Wo          , Wo          , Wo          , Chw         , Wo          , Wo          , Wo          , Wwr         , Ww          , Wwf         , Ww          , Ww          , Wwf         , Ds          , Ds          , Ds^Dr       , Ds          , Rd          , Hd          , Ds          , Hd          
Wo          , Wo          , Wo          , Ww          , Ds          , Ds          , Ds          , Ds          , Ww          , Ww          , Ww          , Wo          , Wo          , Wwr         , Wwr         , Wo          , Wo          , Wo          , Wo          , Wo          , Wo          , Wo          , Wo          , Ww          , Wwf         , Wwf         , Wwf         , Wwf         , Ds          , Ds          , Ds          , Ds          , Ce          , Ce          , Ce          , Hd          , Hd          
Wo          , Wo          , Wo          , Ww          , Ww          , Ds          , Ds          , Ww          , Wwr         , Ww          , Wo          , Wo          , Ww^Vm       , Wwr         , Chw         , Chw         , Wo          , Wo          , Wo          , Wo          , Wo          , Wo          , Ww          , Ww          , Wwf         , Ww          , Wwf         , Wwf         , Ds          , Ds^Dr       , Ds          , Ds          , Ce          , 4 Ke        , Ce          , Hd          , Hd          
Wo          , Wo          , Wo          , Wo          , Ww          , Ds          , Ww          , Ww          , Wwr         , Wwr         , Wo          , Wo          , Wo          , Wo          , Chw         , 2 Khw       , Chw         , Chw         , Wo          , Wo          , Wo          , Ww          , Ww          , Wwf         , Wwf         , Ww          , Wwf         , Wwf         , Ww          , Ds          , Rd          , Rd          , Ds          , Ce          , Hd          , Hd          , Ds          
Wo          , Wo          , Ww          , Ww          , Ww          , Ww          , Ww          , Wwr         , Wwr         , Wo          , Wo          , Wo          , Wo          , Wo          , Wwr         , Chw         , Wo          , Wo          , Wo          , Wo          , Wo          , Wo          , Ww          , Ww^Vm       , Ww          , Ww          , Ww          , Ww          , Ww          , Ww^Bw/      , Rd          , Ds          , Ds          , Ds          , Ds          , Ds          , Ds          
Wo          , Wo          , Ww          , Ww^Vm       , Ww          , Wo          , Wo          , Wo          , Wwr         , Wwr         , Wo          , Wwr         , Wwr         , Wwr         , Wwr         , Wo          , Wo          , Ww^Vm       , Wwr         , Wwr         , Wo          , Wo          , Wo          , Ww          , Wo          , Wo          , Wo          , Wo          , Ww          , Ww^Bw/      , Ds          , Ds          , Ds          , Ds          , Dd^Dr       , Ds          , Ds          
Wo          , Wo          , Wo          , Ww          , Wo          , Wo          , Wo          , Wo          , Wo          , Wo          , Wo          , Wo          , Wwr         , Wo          , Wo          , Wo          , Wo          , Wo          , Wo          , Wwr         , Wo          , Wo          , Wo          , Wo          , Wo          , Wo          , Wo          , Wo          , Ww          , Ww          , Ds          , Dd^Vda      , Ds          , Ds          , Ds          , Ds          , Ds          
Wo          , Wo          , Wo          , Wo          , Wo          , Wo          , Wo          , Wo          , Wo          , Wo          , Wo          , Wo          , Wo          , Wo          , Wo          , Wo          , Wo          , Wo          , Wo          , Wwr         , Wo          , Wo          , Wo          , Wo          , Wo          , Wo          , Ww          , Ww          , Ww          , Ds          , Ds          , Ds          , Ds          , Ds          , Ds          , Ds          , Ds          
