border_size=1
usage=map

Gg          , Gg          , Gg          , Gg          , Gg          , Hh^Fdw      , Hh^Fdw      , Hh^Fdw      , Hh^Fdw      , Hh^Fdw      , Hh^Fdw      , Hh^Fdw      , Gg          , Gg          , Gg          , Gg          , Rd          , Gg          , Gg          , Gg          , Gg          , Gg          , Gg          , Gg          , Gg          , Gg          , Gg          , Gg          , Gg          , Ds          , Ds          , Ds          , Ww          , Ww          , Ww          , Ww          
Gg          , Gg          , Gs^Fmf      , Gg          , Gg          , Gg          , Hh^Fdw      , Hh^Fdw      , Gg          , Hh^Fdw      , Gg          , Gg          , Gg          , Gg          , Gg          , Gg          , Rd          , Gg          , Gg^Vh       , Gg          , Ss          , Gg          , Ss          , Gg          , Ss          , Ss          , Ss          , Gg          , Ds          , Ds          , Ds          , Ds          , Ww          , Ww          , Ww          , Ww          
Gg          , Gs^Fmf      , Gs^Fmf      , Gg          , Gs^Fmf      , Gg          , Gg          , Gg          , Gg          , Gg          , Ss          , Gg          , Ss          , Gg          , Rd          , Rd          , Gg          , Gg          , Gg          , Gg          , Gg          , Ss          , Ss          , Ss          , Ss          , Ss^Vhs      , Gg          , Gg          , Ds          , Ds          , Ww          , Ww          , Ww          , Ww          , Wo          , Wo          
Gg          , Gg          , Gs^Fmf      , Gs^Fmf      , Gs^Fmf      , Gg          , Gs^Fmf      , Gg          , Gs^Fmf      , Ss          , Ss^Vhs      , Ss          , Ss          , Ss          , Rd          , Gg          , Gg          , Gs^Fmf      , Gs^Fmf      , Gs^Fmf      , Gs^Fmf      , Gs^Fmf      , Ss          , Ss          , Ds          , Ss          , Ds          , Ds          , Ds          , Ds          , Ww          , Ww          , Ww          , Ww          , Wo          , Wo          
Gg          , Gg          , Gg          , Gs^Fmf      , Gg          , Gs^Fmf      , Gs^Fmf      , Gs^Fmf      , Ss          , Ss          , Ss          , Gg          , Rd          , Ss^Bw/      , Ss          , Gg          , Ss          , Gs^Fmf      , Gg          , Gg          , Gg          , Gg          , Ss          , Ss          , Ss          , Ds          , Ds          , Ds          , Ww          , Ww          , Ww          , Ww          , Wo          , Wo          , Wo          , Wo          
Gg          , Gg          , Gg          , Gg          , Gs^Fmf      , Gs^Fmf      , Ss          , Ss          , Gs^Fmf      , Gs^Fmf      , Gg          , Gg          , Rd          , Gg          , Ss          , Ss          , Ss          , Gg          , Ds          , Gg          , Ds          , Ds          , Ss          , Ss          , Ww          , Ds          , Ww          , Ww          , Ww^Vm       , Ww          , Ww          , Ww          , Wo          , Wo          , Wo          , Wo          
Gg          , Gg          , Gg^Vo       , Gg          , Ss          , Ss          , Gs^Fmf      , Ss          , Gg          , Gg          , Gg          , Rd          , Gg          , Gg          , Gg          , Ss          , Ss          , Ds          , Ds          , Ds          , Ds          , Ss          , Ww          , Ww          , Ww          , Ww          , Ww          , Ww          , Ww          , Ww          , Wo          , Wo          , Wo          , Wo          , Ww          , Ww          
Rd          , Gg          , Gg          , Gg          , Gg          , Gg          , Gg          , Gs^Fmf      , Gg          , Gg          , Rd          , Rd          , Gg          , Gg          , Gg^Vc       , Gg          , Ds          , Ss          , Ww          , Ww          , Wwf         , Ww          , Ww          , Ww          , Ww          , Ww          , Ww          , Ww          , Wo          , Wo          , Wo          , 1 Wo        , Wo          , Wo          , Ww          , Ww          
Gg          , Rd          , Rd          , Gg          , Rd          , Gg          , Rd          , Gg          , Rd          , Rd          , Gg          , Gg          , Ds          , Gg          , Gg          , Gg          , Ds          , Ds          , Ww          , Ww          , Wwf         , Ww          , Wo          , Wo          , Wo          , Ww          , Wo          , Wo          , Wo          , Wo          , Wo          , Wo          , Ww          , Ww          , Ww          , Ds          
Gg          , Gg          , Gg          , Rd          , Gg          , Rd          , Gg          , Rd          , Gg          , Gg          , Ss          , Ds          , Ds          , Ds          , Ds          , Ds          , Wwf         , Ww          , Wwf         , Wwf         , Ww          , Ww          , Wo          , Wo          , Wo          , Wo          , Wo          , Wo          , Wo          , Wo          , Ww          , Ww          , Ww          , Ww          , Ds          , Ds          
Gg          , Ss          , Gg          , Gg          , Ch          , Ch          , Ch          , Gg          , Gg          , Gg          , Gg          , Ss          , Ss          , Wwf         , Wwf         , Ds          , Wwf         , Ww          , Wwf         , Ww^Vm       , Ww          , Ww          , Ww          , Wo          , Wo          , Wo          , Wo          , Wo          , Wwf         , Ww          , Wwf         , Wwf         , Wwf         , Ds          , Dd^Dc       , Ds          
Gg          , Gg          , Ss          , Gg          , Ch          , 3 Kh        , Ch          , Gg          , Gg          , Gg^Vo       , Gg          , Ss          , Ww          , Ww          , Wwf         , Wwf         , Wwf         , Wwf         , Ww          , Wwf         , Ww          , Ww          , Wo          , Wo          , Wo          , Wo          , Ww          , Ww^Vm       , Wwf         , Wwf         , Ww          , Wwf         , Ds          , Ds          , Ds          , Ds          
Ss          , Ss          , Rp          , Rp          , Rp          , Ch          , Rp          , Gg          , Ss          , Gg          , Ss          , Ss          , Ww          , Wwf         , Ww          , Wwf         , Wwf         , Ww          , Wwf         , Wwf         , Wo          , Wo          , Wo          , Wo          , Wo          , Wo          , Wwf         , Wwf         , Ww          , Ww          , Ds          , Ds          , Ds          , Dd^Vda      , Ds          , Ds          
Ss          , Ss          , Ww          , Rp          , Rp          , Rp          , Rp          , Ss          , Ss          , Ss          , Ww          , Ww          , Wwr         , Wwr         , Wo          , Ww          , Ww          , Wwf         , Wwr         , Wwr         , Wo          , Wo          , Khw         , Chw         , Wo          , Ww          , Wwf         , Ww          , Wwf         , Wwf         , Ss          , Ss          , Ss          , Ds          , Rd          , Rd          
Ww          , Ww          , Ww          , Ww^Bw/      , Ww^Bw/      , Rp          , Ds          , Gg          , Ss          , Ss          , Ww          , Wwr         , Wwr         , Wo          , Wo          , Wo          , Wo          , Wo          , Wwr         , Wwr         , Chw         , Chw         , Wo          , Wwr         , Wwf         , Ww          , Wwf         , Wwf         , Wwf         , Ww          , Ds          , Ds          , Ds          , Ds          , Rd          , Ds          
Ww          , Ww          , Ww          , Ww          , Ww          , Ds          , Dd^Vda      , Ds          , Ww          , Ww          , Ww          , Ww          , Wwr         , Wo          , Wo          , Wo          , Wo          , Wo          , Wo          , Chw         , Wo          , Wo          , Wo          , Wwr         , Ww          , Wwf         , Ww          , Ww          , Wwf         , Ds          , Ds          , Ds^Dr       , Ds          , Rd          , Hd          , Ds          
Wo          , Wo          , Wo          , Ww          , Ds          , Ds          , Ds          , Ds          , Ww          , Ww          , Ww          , Ww^Vm       , Wwr         , Wwr         , Wwr         , Wo          , Chw         , Wo          , Wo          , Wo          , Wo          , Wo          , Wo          , Ww          , Wwf         , Wwf         , Wwf         , Wwf         , Ds          , Ds          , Ds          , Ds          , Ce          , Ce          , Ce          , Hd          
Wo          , Wo          , Wo          , Ww          , Ww          , Ds          , Ds          , Ww          , Wwr         , Ww          , Wo          , Wo          , Wo          , Wwr         , Wo          , Chw         , 2 Khw       , Wo          , Chw         , Wo          , Wo          , Wo          , Ww          , Ww          , Wwf         , Ww          , Wwf         , Wwf         , Ds          , Ds^Dr       , Ds          , Ds          , Ce          , 4 Ke        , Ce          , Hd          
Wo          , Wo          , Wo          , Wo          , Ww          , Ds          , Ww          , Ww          , Wwr         , Wwr         , Wo          , Wo          , Wo          , Wo          , Wo          , Chw         , Chw         , Chw         , Wo          , Wo          , Wo          , Ww          , Ww          , Wwf         , Wwf         , Ww          , Wwf         , Wwf         , Ww          , Ds          , Rd          , Rd          , Ds          , Ce          , Hd          , Hd          
Wo          , Wo          , Ww          , Ww          , Ww          , Ww          , Ww          , Wwr         , Wwr         , Wo          , Wo          , Wo          , Wo          , Wo          , Wwr         , Wo          , Wo          , Wo          , Wo          , Wo          , Wo          , Wo          , Ww          , Ww^Vm       , Ww          , Ww          , Ww          , Ww          , Ww          , Ww^Bw/      , Rd          , Ds          , Ds          , Ds          , Ds          , Ds          
Wo          , Wo          , Ww          , Ww^Vm       , Ww          , Wo          , Wo          , Wo          , Wwr         , Wwr         , Wo          , Wwr         , Wwr         , Wwr         , Wwr         , Wo          , Wo          , Wo          , Wwr         , Wwr         , Wo          , Wo          , Wo          , Ww          , Wo          , Wo          , Wo          , Wo          , Ww          , Ww^Bw/      , Ds          , Ds          , Ds          , Ds          , Dd^Dr       , Ds          
Wo          , Wo          , Wo          , Ww          , Wo          , Wo          , Wo          , Wo          , Wo          , Wo          , Wo          , Wo          , Wwr         , Wo          , Wo          , Wo          , Wo          , Wo          , Wo          , Wwr         , Wo          , Wo          , Wo          , Wo          , Wo          , Wo          , Wo          , Wo          , Ww          , Ww          , Ds          , Dd^Vda      , Ds          , Ds          , Ds          , Ds          
Wo          , Wo          , Wo          , Wo          , Wo          , Wo          , Wo          , Wo          , Wo          , Wo          , Wo          , Wo          , Wo          , Wo          , Wo          , Wo          , Wo          , Wo          , Wo          , Wwr         , Wo          , Wo          , Wo          , Wo          , Wo          , Wo          , Ww          , Ww          , Ww          , Ds          , Ds          , Ds          , Ds          , Ds          , Ds          , Ds          
