border_size=1
usage=map

Wwr         , Wwr         , Wwr         , Wo          , Wo          , Wo          , Wo          , Wo          , Wo          , Wo          , Wo          , Wo          , Wo          , Wo          , Wo          , Wo          , Wo          , Wo          , Wo          , Wo          , Wo          , Wo          , Wo          , Wo          , Wo          , Wo          , Wo          , Wo          , Wo          , Wo          , Wo          
Wwr         , Wwr         , Wo          , Wo          , Wwr         , Wo          , Wwr         , Wo          , Wo          , Wo          , Wo          , Wo          , Wo          , Wo          , Wo          , Wo          , Wo          , Wo          , Wo          , Wwr         , Wwr         , Wo          , Wo          , Wo          , Wo          , Wo          , Wo          , Wo          , Wo          , Wo          , Wo          
Wwr         , Wo          , Ww          , Wwr         , Wwr         , Ww          , Wwr         , Wo          , Wwr         , Wo          , Wo          , Wwr         , Wwr         , Wo          , Wo          , Wo          , Wwr         , Wo          , Wo          , Wwr         , Wo          , Wo          , Wo          , Wo          , Wo          , Wo          , Wo          , Wo          , Wo          , Wo          , Wo          
Wo          , Wwr         , Wwr         , Wo          , Ww^Vm       , Wwr         , Wo          , Ww          , Wwr         , Wo          , Wo          , Wo          , Wwr         , Wwr         , Wwr         , Wwr         , Wwr         , Wwr         , Wwr         , Wo          , Wwr         , Wo          , Wwr         , Wo          , Wwr         , Wo          , 1 Wo        , Wo          , Wo          , Wo          , Wo          
Wo          , Wo          , Wwr         , Wo          , Wo          , Wo          , Ww          , Wwr         , Wo          , Wo          , Wo          , Wwr         , Wo          , Wwr         , Wo          , Wwr         , Wo          , Wo          , Wo          , Wo          , Wo          , Wwr         , Wwr         , Wwr         , Wo          , Wo          , Wo          , Wo          , Wo          , Wo          , Wo          
Wo          , Wwr         , Wwr         , Wo          , Wwr         , Wwr         , Wwr         , Wwr         , Wwr         , Wo          , Wo          , Wo          , Wo          , Ww^Vm       , Wo          , Wo          , Wo          , Wo          , Wo          , Wo          , Wo          , Wo          , Wwr         , Wo          , Wo          , Wo          , Wwr         , Wo          , Wwr         , Wo          , Wo          
Wo          , Wo          , Wwr         , Wo          , Wwr         , Wwr         , Wwr         , Chw         , Chw         , Chw         , Khw         , Wwr         , Wwr         , Wo          , Wwf         , Wo          , Wo          , Wo          , Wo          , Wo          , Wo          , Wwr         , Wwr         , Wwr         , Wo          , Wo          , Wwr         , Wwr         , Wwr         , Wo          , Wo          
Wo          , Wo          , Ww^Vm       , Ww          , Ww^Vm       , Ww          , Wwf         , Chw         , Dd^Dr       , Wo          , Chw         , Chw         , Ds          , Wwf         , Hd          , Ds          , Ds          , Wo          , Wo          , Wo          , Wo          , Wo          , Wwr         , Wwr         , Wwr         , Wwr         , Wwr         , Ww^Vm       , Wwr         , Wo          , Wo          
Wo          , Wo          , Wwr         , Ww          , Wo          , Wo          , Wo          , Wwf         , Wwf         , Ds          , Ds          , Ds          , Hd          , Hd          , Md^Xm       , Hd          , Hd          , Ds          , Wo          , Wo          , Wo          , Wo          , Wo          , Wo          , Wo          , Wo          , Wo          , Wwr         , Wo          , Wo          , Wo          
Wo          , Wwr         , Wo          , Wo          , Wo          , Wwr         , Wo          , Ds          , Ds          , Ds          , Hd          , Hd          , Md^Xm       , Md^Xm       , Wo          , Md^Xm       , Md^Xm       , Hd          , Hd          , Wo          , Wo          , Wo          , Wo          , Wo          , Wo          , Wo          , Wo          , Wo          , Wo          , Wo          , Wo          
Wo          , Wwr         , Wo          , Wo          , Wo          , Wwr         , Ds          , Ds          , Md^Xm       , Hd          , Md^Xm       , Md^Xm       , Hd          , Wo          , Wo          , Wo          , Md^Xm       , Hd          , Hd          , Wo          , Hd          , Wo          , Hd          , Wo          , Wo          , Wo          , Wo          , Wo          , Wo          , Wo          , Hd          
Wo          , Wwr         , Wo          , Wwr         , Wo          , Wo          , Ds          , Md^Xm       , Md          , Md^Xm       , Hd          , Hd          , Wwf         , Wo          , Wo          , Wo          , Hd          , Md^Xm       , Md^Xm       , Hd          , Hd          , Hd          , Hd          , Hd          , Hd          , Hd          , Hd          , Wo          , Hd          , Hd          , Md^Xm       
Wo          , Wo          , Wo          , Wo          , Wo          , Wwr         , Wo          , Ds          , Hd          , Md^Xm       , Hd          , Wwr         , Wwr         , Wwf         , Wwf         , Ds          , Hd          , Dd^Vdt      , Hd          , Md^Xm       , Md^Xm       , Md^Xm       , Md^Xm       , Md^Xm       , Md^Xm       , Md^Xm       , Md^Xm       , Hd          , Md^Xm       , Md^Xm       , Hd          
Wo          , Wo          , Wo          , Ww^Vm       , Wo          , Wo          , Wo          , Wwr         , Wo          , Hd          , Wwr         , Wo          , Wwf         , Wo          , Wwf         , Ww          , Wwf         , Ds          , Wo          , Hd          , Hd          , Hd          , Wwr         , Hd          , Hd          , Hd          , Hd          , Md^Xm       , Hd          , Hd          , Wo          
Wo          , Wo          , Wwr         , Wwr         , Wo          , Wo          , Wo          , Wo          , Wo          , Wo          , Wwf         , Wwf         , Wo          , Wwf         , Wo          , Wwf         , Wo          , Wwf         , Wwf         , Wwf         , Wwf         , Wo          , Wwr         , Wwr         , Wwr         , Dd^Vdt      , Wwr         , Hd          , Wwr         , Wo          , Wo          
Wo          , Wo          , Wo          , Wwr         , Wo          , Wo          , Wwr         , Wo          , Ww^Vm       , Wwr         , Wo          , Wo          , Wo          , Wwf         , Wwr         , Wo          , Wo          , Wo          , Wo          , Wo          , Wwf         , Wwr         , Ww          , Wo          , Wo          , Wwr         , Wwr         , Wwr         , Wwr         , Wwr         , Wo          
Wo          , Wo          , Wo          , Wo          , Wo          , Wo          , Wo          , Wwr         , Wwr         , Wwr         , Wwf         , Wo          , Wo          , Wwr         , Wwf         , Wo          , Wo          , Wo          , Wo          , Wo          , Wwf         , Wwf         , Wo          , Wo          , Wo          , Wwf         , Wwf         , Ww          , Wo          , Wwr         , Wo          
Ds          , Wwf         , Ds          , Ww          , Ww          , Wo          , Wo          , Wo          , Wo          , Wwf         , Wwf         , Wwf         , Wwf         , Wo          , Wwf         , Wwf         , Ds          , Ds          , Ds          , Ds          , Ds          , Wwf         , Ww          , Wo          , Wo          , Wwr         , Wwf         , Wo          , Wo          , Wo          , Wo          
Hd          , Ds          , Hd          , Ds          , Ds          , Wwf         , Wwf         , Ww          , Wwf         , Wwf         , Ds          , Wo          , Ds          , Wo          , Ds          , Ds          , Hd          , Hd          , Hd          , Dd^Vdt      , Hd          , Ds          , Ds^Dr       , Wwr         , Wwr         , Wwr         , Wwf         , Wwf         , Ww          , Wo          , Wo          
Md          , Hd          , Md          , Hd          , Hd          , Ds          , Hd          , Hd          , Hd          , Hd          , Hd          , Ds          , Hd          , Hd          , Hd          , Hd          , Md          , Md          , Md          , Md          , Md          , Hd          , Hd          , Wwr         , Ww          , Wwr         , Chw         , Chw         , Chw         , Wo          , Wo          
Md^Xm       , Md          , Md^Xm       , Md          , Md          , Hd          , Md^Xm       , Hd          , Md^Xm       , Md^Xm       , Md^Xm       , Md^Xm       , Md^Xm       , Md          , Md          , Md          , Md^Xm       , Md^Xm       , Md^Xm       , Md^Xm       , Md^Xm       , Md          , Hd          , Ds          , Wo          , Wo          , Chw         , 3 Khw       , Chw         , Wwr         , Wwr         
Md          , Md^Xm       , Md          , Md^Xm       , Md^Xm       , Md^Xm       , Md          , Md^Xm       , Md          , Md          , Md          , Md          , Md          , Md^Xm       , Md^Xm       , Md^Xm       , Md          , Hd          , Hd          , Hd          , Hd          , Md^Xm       , Hd          , Ds          , Wwr         , Wo          , Wwr         , Chw         , Wwr         , Wwr         , Wo          
Hd          , Md          , Hd          , Md          , Md          , Md          , Hd          , Md          , Hd          , Hd          , Hd          , Hd          , Hd          , Hd          , Hd          , Hd          , Ds          , Hd          , Wwr         , Wwr         , Wwr         , Hd          , Wo          , Wo          , Wo          , Wwr         , Ww^Vm       , Wwr         , Wo          , Wwr         , Wo          
Ds          , Hd          , Ds          , Hd          , Hd          , Hd          , Ds          , Hd          , Wwf         , Wwf         , Wo          , Ww          , Wwr         , Wwr         , Wwr         , Ds          , Wo          , Wwr         , Wo          , Wo          , Wwr         , Wo          , Wo          , Wo          , Wo          , Wwr         , Wwr         , Wwr         , Wo          , Wo          , Wo          
Wo          , Ds          , Wwr         , Ds          , Ds          , Ds          , Wwf         , Wwf         , Wo          , Wwf         , Wwr         , Wwr         , Wo          , Wwr         , Wo          , Wo          , Wo          , Wwf         , Wwr         , Wwf         , Wwf         , Wwr         , Wwr         , Wo          , Wwr         , Wwr         , Wo          , Wo          , Wo          , Wo          , Wo          
Wo          , Wo          , Wwr         , Wwr         , Wwr         , Wwr         , Wwr         , Wwf         , Wo          , Wo          , Wwr         , Wo          , Wo          , Wwr         , Wo          , Wwr         , Wwr         , Wwr         , Wo          , Wwr         , Wo          , Wwr         , Wo          , Wwr         , Wwr         , Wo          , Wo          , Wo          , Wwr         , Wo          , Wo          
Wo          , Wo          , Wwr         , Wwr         , Wo          , Wo          , Wo          , Wwf         , Wo          , Wwr         , Wwr         , Wo          , Wo          , Wwf         , Wwr         , Wo          , Ww^Vm       , Wwf         , Wo          , Wo          , Ww          , Wo          , Wo          , Wwr         , Wwr         , Wo          , Wo          , Wwr         , Wwr         , Wo          , Wo          
Wo          , Wwr         , Wwr         , Ww^Vm       , Wwr         , Wo          , Wwr         , Wwr         , Wwr         , Wwr         , Wwr         , Wwr         , Wo          , Wo          , Wwr         , Wwr         , Wwr         , Wwr         , Wwr         , Ww          , Wwf         , Ww          , Wo          , Wo          , Wwr         , Wo          , Wo          , Wwr         , Wo          , Wwr         , Wo          
Wwr         , Wo          , Wwr         , Wwr         , Wo          , Wwr         , Wo          , Wwr         , Wo          , Wo          , Wwr         , Wo          , Wo          , Wwr         , Wwr         , Wwr         , Wwr         , Wo          , Wwr         , Wwf         , Wo          , Ww          , Wwr         , Wwr         , Wwr         , Wwr         , Wo          , Wo          , Wo          , Wo          , Wo          
Wwr         , Wwr         , Wwr         , Wo          , Chw         , Chw         , Chw         , Wo          , Wwr         , Wwr         , Ww^Vm       , Wwr         , Wwr         , Wwr         , Wwr         , Wo          , Wo          , Wwr         , Wo          , Wwr         , Wo          , Wo          , Wwr         , Ww^Vm       , Wwr         , Wwr         , Wwr         , Wwr         , Wo          , Wo          , Wo          
Wwr         , Wwr         , Wwr         , Wo          , Chw         , 2 Khw       , Chw         , Wwr         , Wo          , Wwr         , Wwr         , Wwr         , Wo          , Wo          , Wwr         , Wwr         , Wo          , Wo          , Wo          , Wwr         , Wwr         , Wwr         , Wwr         , Wwr         , Wo          , Wo          , Wo          , Wo          , Wo          , Wo          , Wo          
Wo          , Wo          , Wo          , Wwr         , Wo          , Chw         , Wwr         , Wwr         , Wo          , Wwr         , Wwr         , Wo          , Wo          , Wo          , Wwr         , Wwr         , Wwr         , Wo          , Wo          , Wo          , Wwr         , Wwr         , Wwr         , Wo          , Wo          , Wo          , Wo          , Wwr         , Wwr         , Wo          , Wo          
Wo          , Wo          , Wo          , Wwr         , Wwr         , Wwr         , Wo          , Wo          , Wo          , Wo          , Wo          , Wo          , Wo          , Wo          , Wwr         , Wwr         , Wwr         , Wo          , Wo          , Wo          , Wo          , Wo          , Wo          , Wo          , Wo          , Wwr         , Wwr         , Wwr         , Wo          , Wo          , Wo          
Wo          , Wo          , Wo          , Wwr         , Wo          , Wwr         , Wo          , Wo          , Wo          , Wo          , Wo          , Wo          , Wo          , Wwr         , Wo          , Wo          , Wo          , Wo          , Wo          , Wo          , Wo          , Wo          , Wo          , Wo          , Wo          , Wo          , Wo          , Wo          , Wo          , Wo          , Wo          
