border_size=1
usage=map

Wwr         , Wwr         , Wwr         , Wo          , Wo          , Wo          , Wo          , Wo          , Wo          , Wo          , Wo          , Wo          , Wo          , Wo          , Wo          , Wo          , Wo          , Wo          , Wo          , Wo          , Wo          , Wo          , Wo          , Wo          , Wo          , Wo          , Wo          , Wo          , Wo          , Wo          , Wo          
Wwr         , Wwr         , Wo          , Wo          , Wwr         , Wo          , Wwr         , Wo          , Wo          , Wo          , Wo          , Wo          , Wo          , Wo          , Wo          , Wo          , Wo          , Wo          , Wo          , Wwr         , Wwr         , Wo          , Wo          , Wo          , Wo          , Wo          , Wo          , Wo          , Wo          , Wo          , Wo          
Wwr         , Wo          , Ww          , Wwr         , Wwr         , Ww          , Wwr         , Wo          , Wwr         , Wo          , Wo          , Wwr         , Wwr         , Wo          , Wo          , Wo          , Wwr         , Wo          , Wo          , Wwr         , Wo          , Wo          , Wo          , Wo          , Wo          , Wo          , Wo          , Wo          , Wo          , Wo          , Wo          
Wo          , Wwr         , Wwr         , Wo          , Ww^Vm       , Wwr         , Ww^Vm       , Wo          , Wwr         , Wo          , Wo          , Wo          , Wwr         , Wwr         , Wwr         , Wwr         , Wwr         , Wwr         , Wwr         , Wo          , Wwr         , Wo          , Wwr         , Wo          , Wwr         , Wo          , 1 Wo        , Wo          , Wo          , Wo          , Wo          
Wo          , Wo          , Wwr         , Wo          , Wo          , Wo          , Wo          , Wwr         , Wo          , Wo          , Wo          , Wwr         , Wo          , Wwr         , Wo          , Wwr         , Wo          , Wo          , Wo          , Wo          , Wo          , Wwr         , Wwr         , Wwr         , Wo          , Wo          , Wo          , Wo          , Wo          , Wo          , Wo          
Wo          , Wwr         , Wwr         , Wo          , Wwr         , Wwr         , Wwr         , Wwr         , Wwr         , Wo          , Wo          , Wo          , Wo          , Ww^Vm       , Wo          , Wo          , Wo          , Wo          , Wo          , Wo          , Wo          , Wo          , Wwr         , Wo          , Wo          , Wo          , Wwr         , Wo          , Wwr         , Wo          , Wo          
Wo          , Wo          , Wwr         , Wo          , Wwr         , Wwr         , Wwr         , Chw         , Chw         , Chw         , Khw         , Wwr         , Wwr         , Wo          , Wwf         , Wo          , Wo          , Wo          , Wo          , Wo          , Wo          , Wwr         , Wwr         , Wwr         , Wo          , Wo          , Wwr         , Wwr         , Wwr         , Wo          , Wo          
Wo          , Wo          , Ww^Vm       , Ww          , Ww^Vm       , Ww          , Wwf         , Chw         , Dd^Dr       , Wo          , Chw         , Chw         , Ds          , Wwf         , Hd          , Ds          , Ds          , Wo          , Wo          , Wo          , Wo          , Wo          , Wwr         , Wwr         , Wwr         , Wwr         , Wwr         , Ww^Vm       , Wwr         , Wo          , Wo          
Wo          , Wo          , Wwr         , Ww          , Wo          , Wo          , Wo          , Wwf         , Wwf         , Ds          , Ds          , Ds          , Hd          , Hd          , Md^Xm       , Hd          , Hd          , Ds          , Wo          , Wo          , Wo          , Wo          , Wo          , Wo          , Wo          , Wo          , Wo          , Wwr         , Wo          , Wo          , Wo          
Wo          , Wwr         , Wo          , Wo          , Wo          , Wwr         , Wo          , Ds          , Ds          , Ds          , Hd          , Hd          , Md^Xm       , Md^Xm       , Wwr         , Md^Xm       , Md^Xm       , Hd          , Hd          , Wo          , Wo          , Wo          , Wo          , Wo          , Wo          , Wo          , Wo          , Wo          , Wo          , Wo          , Wo          
Wo          , Wwr         , Wo          , Wo          , Wo          , Wwr         , Ds          , Ds          , Hd          , Hd          , Md^Xm       , Md^Xm       , Hd          , Wo          , Wo          , Wwr         , Md^Xm       , Hd          , Hd          , Wo          , Hd          , Wo          , Hd          , Wo          , Wo          , Wo          , Wo          , Wo          , Wo          , Wo          , Hd          
Wo          , Wwr         , Wo          , Wwr         , Wo          , Wo          , Ds          , Hd          , Md          , Md^Xm       , Hd          , Hd          , Wwf         , Wo          , Wo          , Wwr         , Hd          , Md^Xm       , Md^Xm       , Hd          , Hd          , Hd          , Hd          , Hd          , Hd          , Hd          , Hd          , Wo          , Hd          , Hd          , Md^Xm       
Wo          , Wo          , Wo          , Wo          , Wo          , Wwr         , Wo          , Ds          , Hd          , Md^Xm       , Hd          , Wwr         , Wwr         , Wwf         , Wwf         , Ds          , Hd          , Dd^Vdt      , Hd          , Md^Xm       , Md^Xm       , Md^Xm       , Md^Xm       , Md^Xm       , Md^Xm       , Md^Xm       , Md^Xm       , Hd          , Md^Xm       , Md^Xm       , Hd          
Wo          , Wo          , Wo          , Ww^Vm       , Wo          , Wo          , Wo          , Ds          , Hd          , Md^Xm       , Hd          , Wwr         , Wwf         , Wo          , Wwf         , Ww          , Wwf         , Ds          , Wo          , Hd          , Hd          , Hd          , Wwr         , Hd          , Hd          , Hd          , Hd          , Md^Xm       , Hd          , Hd          , Wo          
Wo          , Wo          , Wwr         , Wwr         , Wo          , Wo          , Wo          , Wwr         , Hd          , Md^Xm       , Hd          , Hd          , Ww          , Wwf         , Wo          , Wwf         , Wo          , Wwf         , Wwf         , Wwf         , Wwf         , Wo          , Wwr         , Wwr         , Wwr         , Dd^Vdt      , Wwr         , Hd          , Wwr         , Wo          , Wo          
Wo          , Wo          , Wo          , Wwr         , Wo          , Wo          , Wwr         , Wo          , Ww          , Hd          , Wwr         , Wo          , Wo          , Wwr         , Wwr         , Wo          , Wo          , Wo          , Wo          , Wo          , Wwf         , Wwr         , Ww          , Wo          , Wo          , Wwr         , Wwr         , Wwr         , Wwr         , Wwr         , Wo          
Wo          , Wo          , Wo          , Wo          , Wo          , Wo          , Wo          , Wwr         , Wwr         , Wwr         , Wwr         , Wo          , Wo          , Wwr         , Wwf         , Wo          , Wwr         , Wo          , Wwr         , Wo          , Wwf         , Wwf         , Wo          , Wo          , Wo          , Wwf         , Wwf         , Ww          , Wo          , Wwr         , Wo          
Ds          , Wwf         , Ds          , Ww          , Ww          , Wo          , Wo          , Wo          , Wo          , Ww          , Ww^Vm       , Wwr         , Wwr         , Wwr         , Wwf         , Ww          , Wwr         , Wwr         , Ds          , Wwr         , Wwr         , Wwf         , Ww          , Wo          , Wwr         , Wwr         , Wwf         , Wo          , Wo          , Ww^Vm       , Wo          
Ds          , Ds          , Dd^Vdt      , Ds          , Ww          , Wwf         , Wwf         , Ww          , Wwr         , Wwr         , Ww          , Wo          , Wwr         , Wwr         , Ds          , Ds          , Ds          , Ds          , Dd^Vdt      , Ds          , Ds          , Ds          , Ds          , Wwr         , Wwr         , Ds          , Wwf         , Wwf         , Ww          , Wo          , Wo          
Hd          , Ds          , Ds          , Ds          , Ds          , Ds          , Ww          , Wwr         , Wwr         , Wwr         , Wwr         , Wwr         , Ww          , Hd          , Hd          , Hd          , Hd          , Hd          , Md          , Md          , Md          , Hd          , Hd          , Wwr         , Ww          , Wwr         , Chw         , Chw         , Chw         , Wo          , Wo          
Md          , Hd          , Hd          , Hd          , Hd          , Hd          , Hd          , Ww          , Hd          , Ww          , Hd          , Hd          , Hd          , Hd          , Md          , Md          , Md          , Md          , Md^Xm       , Md^Xm       , Md^Xm       , Md          , Hd          , Ds          , Wo          , Wo          , Chw         , 3 Khw       , Chw         , Wwr         , Wwr         
Md^Xm       , Md          , Md          , Md          , Md          , Hd          , Hd          , Hd          , Hd          , Hd          , Md^Xm       , Hd          , Md^Xm       , Hd          , Md^Xm       , Md^Xm       , Md^Xm       , Md^Xm       , Hd          , Hd          , Hd          , Md^Xm       , Hd          , Ds          , Wwr         , Wo          , Wwr         , Chw         , Wwr         , Wwr         , Wo          
Hd          , Md^Xm       , Md^Xm       , Md^Xm       , Md^Xm       , Md^Xm       , Md^Xm       , Md^Xm       , Md^Xm       , Md^Xm       , Hd          , Md^Xm       , Hd          , Md^Xm       , Hd          , Md          , Hd          , Hd          , Wwr         , Wwr         , Wwr         , Hd          , Wo          , Wo          , Ds          , Wwr         , Ww^Vm       , Wwr         , Wo          , Wwr         , Wo          
Ds          , Hd          , Hd          , Hd          , Hd          , Hd          , Hd          , Hd          , Hd          , Hd          , Ds          , Hd          , Ds          , Hd          , Ds          , Ds          , Wwr         , Wwr         , Wo          , Wo          , Wwr         , Wo          , Wo          , Wo          , Wo          , Wwr         , Wwr         , Wwr         , Wo          , Wo          , Wo          
Wo          , Ds          , Wwr         , Ds          , Ds          , Ds          , Ds          , Ds          , Ds          , Ds          , Wwr         , Ds          , Wwr         , Ds          , Wwr         , Wwr         , Wo          , Wwf         , Wwr         , Wwf         , Wwf         , Wwr         , Wwr         , Wo          , Wwr         , Wwr         , Wo          , Wo          , Wo          , Wo          , Wo          
Wo          , Wwr         , Wwr         , Wwr         , Wwr         , Wwr         , Wwr         , Wwr         , Wo          , Wwr         , Wwr         , Wo          , Wo          , Wwr         , Wo          , Wwr         , Wwr         , Wwr         , Wo          , Wwr         , Wo          , Wwr         , Wo          , Wwr         , Wwr         , Wo          , Wo          , Wo          , Wwr         , Wo          , Wo          
Wo          , Wo          , Wwr         , Wwr         , Wo          , Wo          , Wo          , Wwf         , Wo          , Wwr         , Wwr         , Wo          , Wo          , Wwf         , Wwr         , Wo          , Ww^Vm       , Wwf         , Wo          , Wo          , Ww          , Wo          , Wo          , Wwr         , Wwr         , Wo          , Wo          , Wwr         , Ww^Vm       , Wo          , Wo          
Wo          , Wwr         , Wwr         , Ww^Vm       , Wwr         , Wo          , Wwr         , Wwr         , Wwr         , Wwr         , Wwr         , Wwr         , Wo          , Wo          , Wwr         , Wwr         , Wwr         , Wwr         , Wwr         , Ww          , Wwf         , Ww          , Wo          , Wo          , Wwr         , Wo          , Wo          , Wwr         , Wo          , Wwr         , Wo          
Wwr         , Wo          , Wwr         , Wwr         , Wo          , Wwr         , Wo          , Wwr         , Wo          , Wo          , Wwr         , Wo          , Wo          , Ds          , Wwr         , Wwr         , Wwr         , Wo          , Wwr         , Wwf         , Wo          , Ww          , Wwr         , Wwr         , Wwr         , Wwr         , Wo          , Wo          , Wo          , Wo          , Wo          
Wwr         , Wwr         , Wwr         , Wo          , Chw         , Chw         , Chw         , Wo          , Wwr         , Wwr         , Ww^Vm       , Wwr         , Wwr         , Wwr         , Wwr         , Wo          , Wo          , Wwr         , Wo          , Wwr         , Wo          , Wo          , Wwr         , Ww^Vm       , Wwr         , Wwr         , Wwr         , Wwr         , Wo          , Wo          , Wo          
Wwr         , Wwr         , Wwr         , Wo          , Chw         , 2 Khw       , Chw         , Wwr         , Wo          , Wwr         , Wwr         , Wwr         , Wo          , Wo          , Ds          , Wwr         , Wo          , Wo          , Wo          , Wwr         , Wwr         , Wwr         , Wwr         , Wwr         , Wo          , Wo          , Wo          , Wo          , Wo          , Wo          , Wo          
Wo          , Wo          , Wo          , Wwr         , Wo          , Chw         , Wwr         , Wwr         , Wo          , Ds          , Wwr         , Wo          , Wo          , Wo          , Wwr         , Wwr         , Wwr         , Wo          , Wo          , Wo          , Wwr         , Wwr         , Wwr         , Wo          , Wo          , Wo          , Wo          , Wwr         , Wwr         , Wo          , Wo          
Wo          , Wo          , Wo          , Wwr         , Wwr         , Wwr         , Wo          , Wo          , Wo          , Wo          , Wo          , Wo          , Wo          , Wo          , Wwr         , Ww^Vm       , Wwr         , Wo          , Wo          , Wwr         , Wo          , Wo          , Wo          , Wo          , Wo          , Wwr         , Wwr         , Wwr         , Wo          , Wo          , Wo          
Wo          , Wo          , Wo          , Wwr         , Wo          , Wwr         , Wo          , Wo          , Wo          , Wo          , Wo          , Wo          , Wo          , Wwr         , Wo          , Wo          , Wo          , Wo          , Wo          , Wo          , Wo          , Wo          , Wo          , Wo          , Wo          , Wo          , Wo          , Wo          , Wo          , Wo          , Wo          
