border_size=1
usage=map

Aa          , Ai          , Aa          , Ai          , Aa          , Ai          , Ds          , Ai          , Ai          , Aa^Fma      , Ha          , Ha          , Ha          , Aa^Fma      , Aa^Fma      , Aa^Fma      , Aa^Fma      , Gs^Ft       , Gs^Ft       , Ds          , Ds          , Ds          , Ds          , Ds          , Ww          , Ww          , Ww          , Ww          , Wo          , Wo          , Wo          , Wo          , Ww          , Ww          , Ww          , Ww          
Aa          , Ai          , Aa          , Aa          , Ds          , Ds          , Ww          , Ds          , Ds          , Aa^Fma      , Gs^Ft       , Aa^Fma      , Gs^Ft       , Gs^Ft       , Gs^Ft       , Gs^Ft       , Gs^Ft       , Gs^Ft       , Ds          , Ds          , Ds          , Dd^Vdt      , Ds          , Ww          , Ww          , Ww          , Wo          , Wo          , Wo          , Wo          , Ww          , Ww          , Ww          , Ww          , Ww          , Ww          
Aa          , Ai          , Ai          , Ww          , Ww          , Ww          , Ds          , Ww          , Ww          , Ds          , Ds          , Gs^Ft       , Gs^Ft       , Gs^Ft       , Gs^Ft       , Ds          , Ds          , Ds          , Ds          , Ds          , Gs^Ft       , Ds          , Ww          , Ww          , Ww          , Ww          , Wo          , Wo          , Ww          , Ww          , Ww          , Ww          , Ds          , Ds          , Ds          , Ds          
Aa          , Aa          , Ai          , Ai          , Ww          , Ds          , Dd^Vdt      , Ds          , Ww          , Ds          , Ds          , Ds          , Ds          , Ds          , Ds          , Ds          , Gs^Ft       , Gs^Ft       , Gs^Ft       , Gs^Ft       , Ww          , Ww          , Ww          , Ww          , Wo          , Wo          , Ww          , Ww          , Ww          , Ww          , Ww          , Ds          , Ds          , Dd^Vdt      , Ds          , Hd          
Aa          , Aa          , Ai          , Ww          , Gs^Ft       , Ds          , Ds          , Ds          , Ww          , Ds          , Ds          , Dd^Vdt      , Ds          , Dd^Vdt      , Ds          , Gs^Ft       , Ww          , Ww          , Ww          , Ww          , Ww          , Ww          , Wo          , Wo          , Ww          , Ww          , Ww          , Ww          , Gs^Ft       , Ww          , Ds          , 1 Ds        , Ds          , Ds          , Hd          , Hd          
Ha          , Aa          , Aa          , Ww          , Gs^Ft       , Ds          , Dd^Vdt      , Ds          , Gg^Fet      , Ww          , Gg^Fet      , Gg^Fet      , Chw         , Gg^Fet      , Gg^Fet      , Gg^Fet      , Ww          , Ww          , Ww          , Ww          , Wo          , Wo          , Wo          , Ww          , Ww          , Ww          , Ww          , Gs^Ft       , Ds          , Ds          , Ds          , Ds          , Ds          , Ds          , Ds          , Hd          
Ha          , Aa          , Aa          , Ww          , Gs^Ft       , Ds          , Ds          , Ds          , Gg^Fet      , Ww          , Chw         , 2 Khw       , Gg^Fet      , Chw         , Ww          , Ww          , Wwr         , Ww          , Wo          , Wo          , Ww          , Ww          , Ww          , Ww          , Ww          , Ww          , Ss          , Ds          , Ds          , Dd          , Gs^Ft       , Ds          , Ss          , Gs^Ft       , Gs^Ft       , Ds          
Ha          , Ha          , Aa          , Ww          , Ww          , Gs^Ft       , Ds          , Gs^Ft       , Gg^Fet      , Chw         , Gg^Fet      , Gg^Fet      , Ww          , Ww          , Ww          , Wwr         , Wo          , Wo          , Wo          , Wo          , Ww          , Ww          , Ww          , Ww          , Ds          , Gg^Fet      , Gs^Ft       , Ss          , Ds          , Gs^Ft       , Ss          , Ds          , Ss          , Gs^Ft       , Ss          , Ss          
Ha          , Ha          , Ha          , Aa          , Ww          , Gs^Ft       , Gs^Ft       , Ds          , Ds          , Chw         , Wwr         , Wwr         , Ww^Vm       , Ww          , Wo          , Wo          , Wo          , Wo          , Ww          , Ww          , Ww          , Ww          , Gs^Ft       , Ds          , Dd^Vdt      , Ds          , Ss          , Ss          , Ss          , Ss          , Ss          , Ss^Vm       , Ss          , Ss          , Ww          , Ww          
Ha          , Ha          , Aa          , Aa          , Ds          , Ww          , Gs^Ft       , Gs^Ft       , Gs^Ft       , Ds          , Ww          , Ww          , Ww          , Ww          , Wo          , Wo          , Wwr         , Ww          , Ww          , Ww          , Gg^Fet      , Gs^Ft       , Gg^Fet      , Ds          , Ds          , Ds          , Ss          , Ss          , Ss          , Ds          , Ds          , Ds          , Ss          , Ss          , Ww          , Ds          
Ha          , Aa          , Aa^Vha      , Aa          , Ds          , Ww          , Ww          , Ww          , Ww          , Ww          , Wwr         , Wo          , Wo          , Wo          , Ww          , Wwr         , Ww          , Ww          , Ss          , Ss          , Chw         , Gg^Fet      , Khw         , Gg^Fet      , Ss          , Ss          , Ds          , Ds          , Ss          , Ds          , Ds          , Ds          , Ww          , Ww          , Ds          , Ds          
Aa          , Aa          , Aa          , Aa          , Ds          , Ds          , Ww          , Ww          , Ww          , Wwr         , Wo          , Wo          , Wo          , Ww          , Ww          , Ww          , Gs^Ft       , Ww          , Ww          , Gs^Ft       , Gg^Fet      , Chw         , Chw         , Chw         , Gg^Fet      , Ss          , Ds          , Ds          , Ss          , Ss          , Ss          , Ss          , Ww          , Ds          , Ds          , Hd          
Aa          , Aa          , Aa          , Ds          , Ds          , Ww          , Ww          , Wwr         , Wwr         , Wo          , Wo          , Wwr         , Ww          , Ww          , Ss          , Ss          , Ss          , Gs^Ft       , Ss          , Ww          , Ww          , Ww          , Ss          , Ss          , Ss          , Ss          , Ss          , Ss          , Ds          , Ss          , Ww          , Ww          , Ss          , Ds          , Ds          , Hd          
Ds          , Ds          , Ds          , Ds          , Ww          , Ww          , Wwr         , Wwr         , Wo          , Wo          , Wwr         , Ww          , Ww          , Ww          , Ss          , Ss^Vhs      , Ds          , Ds          , Ss          , Ss          , Ss          , Ss          , Ss          , Ds          , Ds          , Ds          , Ds          , Ss          , Ds          , Ss          , Ww          , Ss          , Ds          , Ds          , Dd^Vdt      , Ds          
Ds          , Dd^Dc       , Ds          , Ds          , Ww          , Wwr         , Wwr         , Wwr         , Wo          , Wo          , Ww          , Ww          , Wwf         , Ss          , Ds          , Ss          , Ss          , Ds          , Ds          , Ds          , Ss          , Ds          , Ds          , Ss          , Ds          , Dd^Vdt      , Ds          , Dd          , Ds          , Ww          , Ss          , Ss          , Ds          , Ds          , Ds          , Ds          
Aa          , Ds          , Ds          , Ds          , Ww          , Ww          , Wwr         , Wo          , Wo          , Ww          , Ww          , Wwf         , Ss          , Ss          , Ss          , Ds          , Ds          , Ds          , Ds          , Ss          , Ds          , Ds          , Ds          , Ss          , Ss          , Ds          , Ss          , Ds          , Ww          , Ww          , Ds          , Ss          , Ss          , Ss          , Ss          , Ss          
Aa          , Aa          , Ds          , Ww          , Ww          , Ww          , Wo          , Wo^Bw\      , Ww          , Ww          , Wwf         , Wwf         , Ss          , Ss          , Ds          , Ds          , Ss          , Ss          , Ss          , Ss          , Ds          , Ds^Dr       , Ds          , Ds          , Ss          , Ss          , Ss          , Ww          , Ss          , Ds          , Ds          , Ss          , Ss          , Ss          , Ds          , Ss          
Aa          , Ds          , Ds          , Ww          , Ww          , Ww          , Wo          , Wo          , Ww          , Ww          , Wwf         , Ds          , Ds          , Ss          , Ds          , Ds          , Ss          , Ss          , Ss          , Ds          , Ds          , Ds          , Gs^Ft       , Ds          , Ds          , Ds          , Ww          , Ww          , Ss          , Ss          , Ds          , Ds          , Ss          , Ss          , Ds          , Ds          
Ds          , Ds          , Ww          , Ww          , Ww          , Wwr         , Wo          , Wo          , Ww          , Wwf         , Wwf         , Ds          , Ss          , Ds          , Ss          , Ds          , Ss          , Ss          , Ss^Vhs      , Ds          , Ss          , Gs^Ft       , Gs^Ft       , Ds          , Ds          , Ww^Bw\      , Ds          , Ds          , Ds          , Ss          , Ss          , Gs^Ft       , Gs^Ft       , Gs^Ft       , Gs^Ft       , Ds          
Ds          , Ds          , Ww          , Ww          , Ww          , Wwr         , Wo          , Wo          , Ww^Vm       , Wwf         , Wwf         , Ds          , Gs^Ft       , Ss          , Ss          , Ss          , Ds          , Ds          , Ds          , Ss          , Ss          , Ss          , Ss          , Ss          , Ww          , Ww          , Ss          , Ds          , Dd^Vda      , Ds          , Ss          , Ss          , Ss          , Gs^Ft       , Ds          , Ds          
Ds          , Ds          , Ww          , Ww          , Ww          , Wo          , Wo          , Wo          , Ww          , Wwf         , Ds          , Ds          , Ds          , Ds          , Gs^Ft       , Ss          , Ds          , Ds          , Gs^Ft       , Ss          , Ww          , Ww          , Ww          , Ss          , Ww          , Ss          , Ss          , Ds          , Ds          , Ds          , Ds          , Ds          , Ds          , Ss          , Ss          , Ss          
Ds          , Ds          , Ww          , Ww          , Wwr         , Wo          , Wo          , Wwr         , Ww          , Wwf         , Ds          , Ds          , Ds          , Ds          , Ds          , Ds          , Ds          , Ds          , Gs^Ft       , Ww          , Ss          , Ss          , Ss          , Ww          , Ds          , Ss          , 4 Ds        , Ss          , Ss          , Ds          , Ds          , Ds          , Ss          , Ss          , Ds          , Ss          
Ds          , Ds          , Ww          , Ww          , Wwr         , Wo          , Wo          , Wwr         , Ww          , Wwf         , Chw         , Ce          , Ce          , Re          , Re          , Re          , Re          , Ds          , Ww          , Ww          , Ss          , Ss          , Ds          , Ds          , Dd^Dc       , Ds          , Ds          , Ss          , Ds          , Ds          , Ss          , Ds          , Ss          , Ss          , Ds          , Ds          
Ds          , Ds          , Ww          , Ww          , Wo          , Wo          , Wo          , Ww          , Ww          , Wwf         , Chw         , 3 Ke        , Ce          , Ds          , Ds          , Ds          , Ww          , Ww^Bw\      , Ds          , Ds          , Ds          , Ss          , Gs^Ft       , Ds          , Ds          , Ds          , Ss          , Ss          , Ss          , Ds          , Ss          , Ss          , Ds          , Ds          , Dd^Vdt      , Ds          
Ds          , Ww          , Ww          , Ww          , Wo          , Wo          , Wo          , Ww          , Ww          , Ds          , Ds          , Ce          , Ds          , Ss          , Ss          , Ss          , Ww          , Ds          , Dd^Vda      , Ds          , Ss          , Ss          , Ss          , Gs^Ft       , Ss          , Ss          , Ss          , Ss          , Ss          , Ss          , Ss          , Ss          , Ss          , Ds          , Ds          , Ds          
Ds          , Ww          , Ww          , Ww          , Wo          , Wo          , Wwr         , Ww          , Ww          , Ds          , Ss          , Ds          , Ss          , Ss          , Ww          , Ww          , Ss          , Ds          , Ds          , Ds          , Ss          , Ss          , Ss          , Ss          , Ds          , Ss          , Ds          , Ds          , Ds          , Ds          , Ss          , Ss          , Ds          , Ds          , Hd          , Hd          
Ds          , Ww          , Ww          , Ww          , Wo          , Wo          , Wwr         , Ww          , Ww          , Ds          , Ss          , Ss          , Ss          , Ss          , Ww          , Ss          , Ss          , Ss          , Ss          , Ss          , Ds          , Ds          , Ds          , Ss          , Ds          , Ds          , Dd^Vdt      , Ds          , Ds          , Ds          , Ds          , Ss          , Ds          , Ds          , Hd          , Hd          
Ds          , Ww          , Ww          , Wo          , Wo          , Wo          , Ww          , Ww          , Ww          , Ss          , Ss          , Ss          , Ss          , Ww          , Ss          , Ss          , Ss          , Ds          , Ds          , Ds          , Ds          , Ds          , Ds          , Ds          , Ds          , Ds          , Ds          , Ds          , Ds          , Ds          , Ds          , Ds          , Hd          , Hd          , Hd          , Hd          
