border_size=1
usage=map

Wwr         , Wwr         , Wwr         , Wo          , Wo          , Wo          , Wo          , Wo          , Wo          , Wo          , Wo          , Wo          , Wo          , Wo          , Wo          , Wo          , Wo          , Wo          , Wo          , Wo          , Wo          , Wo          , Wo          , Wo          , Wo          , Wo          , Wo          , Wo          , Wo          , Wo          , Wo          
Wwr         , Wwr         , Wo          , Wo          , Wwr         , Wo          , Wo          , Wo          , Wo          , Wo          , Wo          , Wo          , Wo          , Wo          , Wo          , Wo          , Wo          , Wo          , Wo          , Wwr         , Wwr         , Wo          , Wo          , Wo          , Wo          , Wo          , Wo          , Wo          , Wo          , Wo          , Wo          
Wwr         , Wo          , Ww          , Wwr         , Wwr         , Wo          , Wwr         , Wo          , Wo          , Wo          , Wo          , Wwr         , Wwr         , Wo          , Wo          , Wo          , Wwr         , Wo          , Wo          , Wwr         , Wo          , Wo          , Wo          , Wo          , Wo          , Wo          , Wo          , Wo          , Wo          , Wo          , Wo          
Wo          , Wwr         , Wwr         , Wo          , Ww^Vm       , Wwr         , Ww^Vm       , Wo          , Wo          , Wo          , Wo          , Wo          , Wwr         , Wwr         , Wwr         , Wwr         , Wwr         , Wwr         , Wwr         , Wo          , Wwr         , Wo          , Wwr         , Wo          , Wwr         , Wo          , 1 Wo        , Wo          , Wo          , Wo          , Wo          
Wo          , Wo          , Wwr         , Wo          , Wo          , Wo          , Wo          , Wwr         , Wo          , Wo          , Wo          , Wwr         , Wo          , Wwr         , Wo          , Wwr         , Wo          , Wo          , Wo          , Wo          , Wo          , Wwr         , Wwr         , Wwr         , Wo          , Wo          , Wo          , Wo          , Wo          , Wo          , Wo          
Wo          , Wwr         , Wwr         , Wo          , Wwr         , Wwr         , Wwr         , Wwr         , Wwr         , Wo          , Wo          , Wo          , Wo          , Ww^Vm       , Wo          , Wo          , Wo          , Wo          , Wo          , Wo          , Wo          , Wo          , Wwr         , Wo          , Wo          , Wo          , Wwr         , Wo          , Wwr         , Wo          , Wo          
Wo          , Wo          , Wwr         , Wo          , Wwr         , Wwr         , Wwr         , Chw         , Chw         , Chw         , Khw         , Wwr         , Wwr         , Wo          , Wwf         , Wo          , Wo          , Wo          , Wo          , Wo          , Wo          , Wwr         , Wwr         , Wwr         , Wo          , Wo          , Wwr         , Wwr         , Wwr         , Wo          , Wo          
Wo          , Wo          , Ww^Vm       , Ww          , Ww^Vm       , Ww          , Wwf         , Chw         , Dd^Do       , Wo          , Chw         , Chw         , Ds          , Wwf         , Hd          , Ds          , Ds          , Wo          , Wo          , Wo          , Wo          , Wo          , Wwr         , Wwr         , Wwr         , Wwr         , Wwr         , Ww^Vm       , Wwr         , Wo          , Wo          
Wo          , Wo          , Wwr         , Wo          , Wo          , Wo          , Wo          , Wwf         , Wwf         , Ds          , Ds          , Ds          , Hd          , Hd          , Md^Xm       , Hd          , Hd          , Wo          , Wo          , Wo          , Wo          , Wo          , Wo          , Wo          , Wo          , Wo          , Wo          , Wwr         , Wo          , Wo          , Wo          
Wo          , Wwr         , Wo          , Wo          , Wo          , Wwr         , Wo          , Ds          , Ds          , Ds          , Hd          , Hd          , Md^Xm       , Md^Xm       , Wwr         , Md^Xm       , Md^Xm       , Hd          , Wo          , Wo          , Wo          , Wo          , Wo          , Wo          , Wo          , Wo          , Wo          , Wo          , Wo          , Wo          , Wo          
Wo          , Wwr         , Wo          , Wo          , Wo          , Wwr         , Ds          , Ds          , Hd          , Hd          , Md^Xm       , Md^Xm       , Hd          , Wo          , Wo          , Wwr         , Md^Xm       , Hd          , Hd          , Wo          , Wo          , Wo          , Wo          , Wo          , Wo          , Wo          , Wo          , Wo          , Wo          , Wo          , Hd          
Wo          , Wwr         , Wo          , Wwr         , Wo          , Wo          , Ds          , Hd          , Md          , Md^Xm       , Hd          , Hd          , Wwr         , Wo          , Wo          , Wwr         , Hd          , Md^Xm       , Md^Xm       , Hd          , Hd          , Hd          , Hd          , Wo          , Wo          , Wo          , Wo          , Wo          , Hd          , Hd          , Md^Xm       
Wo          , Wo          , Wo          , Wo          , Wo          , Wwr         , Ds          , Ds          , Hd          , Md^Xm       , Hd          , Wwr         , Wo          , Wo          , Ww          , Ds          , Hd          , Dd^Vdt      , Hd          , Md^Xm       , Md^Xm       , Md^Xm       , Md^Xm       , Hd          , Hd          , Hd          , Md          , Hd          , Md^Xm       , Md^Xm       , Hd          
Wo          , Wo          , Wo          , Ww^Vm       , Wo          , Wo          , Wo          , Ds          , Hd          , Md^Xm       , Hd          , Wwr         , Wwr         , Wo          , Wwr         , Wwr         , Wwr         , Ds          , Ww          , Ww          , Wwr         , Ww          , Ww          , Md^Xm       , Md^Xm       , Md^Xm       , Md^Xm       , Md^Xm       , Hd          , Hd          , Wo          
Wo          , Wo          , Wwr         , Wwr         , Wo          , Wo          , Wo          , Ds          , Hd          , Md^Xm       , Hd          , Hd          , Ww          , Wwr         , Wo          , Wwr         , Wo          , Wwr         , Wwr         , Wwr         , Wo          , Wo          , Wwr         , Wwr         , Hd          , Dd^Vdt      , Hd          , Hd          , Wwr         , Wo          , Wo          
Wo          , Wo          , Wo          , Wwr         , Wo          , Wo          , Wwr         , Ds          , Hd          , Md^Xm       , Hd          , Wo          , Wo          , Wwr         , Wwr         , Wo          , Wo          , Wo          , Wo          , Wwr         , Wwr         , Wo          , Wwr         , Wwr         , Wo          , Wwr         , Ww          , Wwr         , Wwr         , Wwr         , Wo          
Wo          , Wo          , Wo          , Wo          , Wo          , Wo          , Wo          , Ds          , Wwr         , Hd          , Wwr         , Wo          , Wo          , Wwr         , Ww          , Wo          , Ww          , Wo          , Ww          , Wo          , Wwr         , Wwr         , Wo          , Wo          , Wo          , Wwr         , Wwr         , Wwr         , Wo          , Wwr         , Wo          
Ww          , Wwf         , Ww          , Wo          , Wo          , Wo          , Wo          , Wo          , Wo          , Wwr         , Ww^Vm       , Wwr         , Wwr         , Wwr         , Wwr         , Ww          , Wwr         , Ww          , Wwf         , Wwf         , Wwr         , Ww          , Ww          , Wo          , Ww          , Ww          , Wwr         , Wo          , Wo          , Ww^Vm       , Wo          
Ww          , Ww          , Ww          , Wo          , Ww          , Wwr         , Wwr         , Wo          , Wo          , Wo          , Wo          , Wo          , Wo          , Wwr         , Wwr         , Wwr         , Wwr         , Wwr         , Ds          , Ds          , Ds          , Ww          , Wwr         , Wwr         , Wwr         , Ds          , Ww          , Wwr         , Ww          , Wo          , Wo          
Ds          , Ww          , Ds          , Ww          , Ww          , Ww          , Ww          , Wo          , Ww          , Wo          , Wo          , Wo          , Ww          , Wwr         , Ww          , Wwr         , Ds          , Ds          , Hd          , Dd^Vdt      , Ds          , Wwf         , Hd          , Wwr         , Ww          , Wwr         , Wwr         , Wwr         , Ww          , Wo          , Wo          
Ds          , Ds          , Dd^Vdt      , Ds          , Ww          , Ww          , Ww          , Ww          , Ww          , Ww          , Ww          , Ww          , Ds          , Ww          , Ds          , Ds          , Hd          , Hd          , Md^Xm       , Hd          , Hd          , Hd          , Hd          , Ds          , Wo          , Wo          , Chw         , Chw         , Chw         , Wwr         , Wwr         
Hd          , Ds          , Ds          , Ds          , Ds          , Ds          , Ds          , Ds          , Ds          , Ds          , Ds          , Ds          , Hd          , Ds          , Hd          , Hd          , Md^Xm       , Md^Xm       , Hd          , Md^Xm       , Md^Xm       , Md^Xm       , Hd          , Ds          , Wwr         , Wo          , Chw         , 3 Khw       , Chw         , Wwr         , Wo          
Hd          , Hd          , Hd          , Hd          , Hd          , Hd          , Hd          , Hd          , Hd          , Hd          , Hd          , Hd          , Md^Xm       , Hd          , Md^Xm       , Md^Xm       , Hd          , Hd          , Ds          , Hd          , Ds          , Hd          , Ds          , Wwr         , Wwr         , Wwr         , Wwr         , Chw         , Wo          , Ww          , Wo          
Md^Xm       , Hd          , Md^Xm       , Md^Xm       , Md^Xm       , Md^Xm       , Md^Xm       , Md^Xm       , Md^Xm       , Md^Xm       , Md^Xm       , Md^Xm       , Hd          , Md^Xm       , Hd          , Hd          , Ds          , Ds          , Ds          , Ds          , Wwr         , Ds          , Wwr         , Ww          , Ds          , Wwr         , Ww^Vm       , Wo          , Wo          , Wo          , Wo          
Hd          , Md^Xm       , Hd          , Hd          , Hd          , Hd          , Hd          , Hd          , Hd          , Hd          , Hd          , Hd          , Ds          , Hd          , Ds          , Ds          , Ds          , Dd^Vda      , Ds          , Wwr         , Wwr         , Wwr         , Wwr         , Wo          , Wo          , Ww          , Ww          , Wo          , Wo          , Wo          , Wo          
Ds          , Hd          , Ds          , Ds          , Ds          , Ds          , Ds          , Ds          , Ds          , Ds          , Ds          , Ds          , Wwr         , Ds          , Ds          , Wo          , Wo          , Ds          , Wwr         , Wwr         , Ww          , Wo          , Wo          , Wo          , Wwr         , Wwr         , Wo          , Wo          , Wwr         , Wo          , Wo          
Wo          , Ds          , Wwr         , Wwr         , Wo          , Wo          , Wo          , Wwf         , Wo          , Wwr         , Wwr         , Wo          , Wo          , Wwf         , Wwr         , Wo          , Ww          , Wwr         , Wo          , Ww          , Wo          , Wo          , Ww          , Wwr         , Wwr         , Wwr         , Wo          , Wwr         , Ww          , Wo          , Wo          
Wo          , Wwr         , Wwr         , Wwr         , Wwr         , Wo          , Wwr         , Wwr         , Wwr         , Wwr         , Wwr         , Wwr         , Wo          , Wo          , Wwr         , Wwr         , Wwr         , Ww          , Wo          , Ww          , Ww          , Wo          , Ww          , Wo          , Wwr         , Wo          , Wo          , Wwr         , Ww^Vm       , Wwr         , Wo          
Wwr         , Wo          , Wwr         , Ww^Vm       , Wo          , Wwr         , Wo          , Wwr         , Wo          , Wo          , Wwr         , Wo          , Wo          , Ds          , Wwr         , Wwr         , Wwr         , Wo          , Wwr         , Wwr         , Ds          , Ww          , Wwr         , Wo          , Wwr         , Wwr         , Wo          , Wo          , Wo          , Wo          , Wo          
Wwr         , Wwr         , Wwr         , Wo          , Wo          , Wo          , Wwr         , Wwr         , Wwr         , Wwr         , Ww^Vm       , Wwr         , Wwr         , Wwr         , Wwr         , Wo          , Wo          , Wwr         , Wo          , Wwr         , Wo          , Wo          , Wwr         , Wwr         , Wwr         , Wwr         , Wwr         , Wwr         , Wo          , Wo          , Wo          
Wwr         , Wwr         , Wwr         , Wo          , Wo          , Wo          , Wo          , Wwr         , Wo          , Wwr         , Wwr         , Wwr         , Wwr         , Wo          , Ds          , Wwr         , Wo          , Wo          , Wo          , Wwr         , Wwr         , Wwr         , Wo          , Ww          , Wo          , Wo          , Wo          , Wo          , Wo          , Wo          , Wo          
Wo          , Wo          , Wwr         , Wwr         , Chw         , Chw         , Chw         , Wwr         , Wo          , Ds          , Wwr         , Wo          , Wo          , Ww          , Wo          , Wwr         , Wo          , Wo          , Wo          , Wo          , Wwr         , Wwr         , Wo          , Wwr         , Wo          , Wo          , Wo          , Wwr         , Wwr         , Wo          , Wo          
Wo          , Wo          , Wo          , Wwr         , Chw         , 2 Khw       , Chw         , Wo          , Wwr         , Wwr         , Wo          , Wo          , Ww          , Ww          , Wwr         , Wo          , Wo          , Wo          , Wo          , Wwr         , Wo          , Wo          , Wwr         , Wo          , Wo          , Ww^Vm       , Wwr         , Wwr         , Wo          , Wo          , Wo          
Wo          , Wo          , Wo          , Wwr         , Wwr         , Chw         , Wo          , Wwr         , Wwr         , Wwr         , Wwr         , Wo          , Wo          , Wwr         , Wwr         , Ww^Vm       , Wo          , Wo          , Wwr         , Wwr         , Wo          , Wo          , Wwr         , Wo          , Wo          , Wo          , Wwr         , Wwr         , Wo          , Wo          , Wo          
Wo          , Wo          , Wwr         , Wwr         , Wo          , Wo          , Wo          , Wo          , Wo          , Wo          , Wwr         , Wo          , Wo          , Wo          , Wo          , Wo          , Wo          , Wo          , Wwr         , Wwr         , Wwr         , Wo          , Wo          , Wo          , Wo          , Wwr         , Wwr         , Wwr         , Wwr         , Wo          , Wo          
Wo          , Wo          , Wo          , Wwr         , Wo          , Wo          , Wo          , Wo          , Wo          , Wo          , Wo          , Wo          , Wo          , Wo          , Wo          , Wo          , Wo          , Wo          , Wo          , Wo          , Wo          , Wo          , Wo          , Wo          , Wo          , Wo          , Wo          , Wo          , Wo          , Wo          , Wo          
